2,0,0,0,0,0,6,0,0
0,0,0,6,0,2,9,5,0
0,0,0,3,0,0,0,1,0
0,9,0,0,6,3,0,0,0
0,0,6,9,0,5,2,4,0
3,5,0,2,1,0,0,0,0
0,0,0,5,0,0,0,0,4
0,4,0,0,0,0,5,0,0
0,6,0,0,0,0,0,7,0
