0,0,1,0,0,8,0,0,0
9,5,0,3,0,7,6,0,0
0,0,0,0,1,0,0,0,8
0,0,0,0,3,0,1,9,0
1,0,4,9,0,0,0,0,0
3,0,9,0,0,5,0,0,6
5,0,3,8,0,0,0,0,0
0,0,0,4,7,0,0,0,0
7,0,0,0,0,9,3,0,0
