0,0,0,0,0,7,0,0,2
0,0,0,0,0,0,0,6,0
3,9,2,0,0,0,5,0,0
2,0,5,6,9,0,0,8,0
0,0,7,8,5,0,6,0,0
0,6,0,7,0,0,0,2,0
0,0,0,0,0,5,0,7,0
0,0,8,0,0,0,0,0,3
1,0,0,0,6,0,0,0,0
