9,4,2,7,1,3,8,5,6
5,6,7,8,2,4,3,9,1
3,8,1,5,6,9,4,2,7
8,7,3,2,5,1,6,4,9
4,2,6,9,3,8,1,7,5
1,5,9,4,7,6,2,8,3
6,9,5,1,8,2,7,3,4
2,3,4,6,9,7,5,1,8
7,1,8,3,4,5,9,6,2
