2,6,8,3,7,1,5,4,9
5,1,3,4,9,2,7,8,6
9,4,7,6,5,8,1,3,2
6,8,2,5,1,9,3,7,4
3,5,1,2,4,7,9,6,8
4,7,9,8,3,6,2,1,5
7,2,4,9,6,3,8,5,1
1,9,6,7,8,5,4,2,3
8,3,5,1,2,4,6,9,7
