0,0,0,0,0,0,0,0,0
0,0,4,0,0,0,8,0,0
0,8,0,9,0,0,1,0,0
0,3,0,7,0,0,6,9,0
0,0,0,0,0,1,0,0,0
7,6,5,0,0,0,0,0,1
0,9,6,0,4,0,0,0,0
5,0,0,0,8,0,0,6,0
8,0,3,1,6,0,9,0,4
