8,7,3,6,9,5,1,2,4
1,6,9,4,2,8,3,7,5
5,2,4,7,3,1,8,6,9
4,9,6,3,5,2,7,8,1
7,5,8,1,6,4,2,9,3
3,1,2,8,7,9,4,5,6
9,8,7,5,4,3,6,1,2
6,3,5,2,1,7,9,4,8
2,4,1,9,8,6,5,3,7
