0,1,0,8,0,0,0,0,0
9,0,4,0,7,3,2,0,1
0,3,0,0,0,0,0,0,4
0,6,1,0,0,0,0,0,0
2,0,0,0,0,0,0,0,0
8,4,9,0,6,0,0,0,0
0,0,0,0,9,6,3,0,0
0,9,3,0,4,7,1,0,0
0,0,7,0,8,0,0,0,2
