0,0,0,0,0,0,5,0,0
0,2,1,0,0,5,0,4,0
6,0,0,0,0,0,0,0,0
2,0,0,0,0,0,0,0,1
0,0,7,1,0,2,0,8,0
0,5,0,0,0,8,0,7,4
0,1,6,5,8,0,0,0,0
0,0,8,4,0,0,0,0,3
0,0,0,0,3,6,0,0,0
