9,1,2,8,4,6,5,7,3
8,5,3,7,2,1,6,9,4
6,4,7,9,5,3,2,1,8
1,7,6,2,3,8,4,5,9
2,3,9,4,1,5,8,6,7
5,8,4,6,9,7,3,2,1
4,6,5,1,8,9,7,3,2
7,9,8,3,6,2,1,4,5
3,2,1,5,7,4,9,8,6
