7,3,9,8,6,4,5,1,2
8,2,1,3,7,5,9,4,6
6,4,5,2,1,9,8,3,7
2,8,4,7,5,3,6,9,1
9,6,7,1,4,2,3,8,5
1,5,3,6,9,8,2,7,4
3,1,6,5,8,7,4,2,9
5,9,8,4,2,1,7,6,3
4,7,2,9,3,6,1,5,8
