1,8,9,4,2,3,6,7,5
6,5,3,9,8,7,1,4,2
4,7,2,5,1,6,8,9,3
5,3,8,7,9,4,2,1,6
7,9,6,2,5,1,3,8,4
2,1,4,6,3,8,7,5,9
8,4,7,3,6,5,9,2,1
9,6,5,1,7,2,4,3,8
3,2,1,8,4,9,5,6,7
