0,0,0,2,0,7,0,0,3
0,0,0,0,1,5,9,2,0
0,8,0,0,4,0,0,1,0
0,4,0,5,8,0,0,0,9
0,0,0,0,0,0,0,5,0
0,0,0,0,0,3,8,7,0
0,0,0,0,2,0,0,0,0
1,3,0,0,0,8,0,9,0
0,0,4,9,0,0,0,0,0
