1,0,9,0,4,0,0,0,0
2,7,4,0,0,0,0,0,0
0,0,8,0,0,0,0,7,5
0,1,5,0,0,0,0,8,0
0,2,0,0,0,0,0,4,0
0,0,0,0,0,0,0,0,9
0,0,2,0,5,0,0,0,6
0,4,0,8,0,2,0,5,0
0,0,0,7,0,9,0,1,0
