3,1,0,0,8,0,0,6,4
4,0,0,6,0,7,1,0,0
0,0,6,0,0,0,5,0,8
0,0,0,0,0,3,0,9,0
1,4,0,0,0,8,0,0,0
5,0,0,0,0,0,0,0,1
0,8,0,0,0,0,0,4,0
0,0,0,0,0,0,0,0,6
0,0,0,0,3,1,8,0,7
