1,4,5,8,2,6,9,3,7
6,3,7,9,5,4,8,2,1
9,2,8,3,1,7,6,5,4
2,5,1,7,8,3,4,6,9
8,6,3,1,4,9,2,7,5
4,7,9,2,6,5,1,8,3
7,1,4,6,3,2,5,9,8
5,9,2,4,7,8,3,1,6
3,8,6,5,9,1,7,4,2
