7,5,6,3,2,9,8,4,1
1,4,9,8,6,7,3,5,2
8,3,2,5,1,4,7,9,6
3,9,1,7,5,2,4,6,8
5,6,8,4,9,1,2,3,7
4,2,7,6,3,8,5,1,9
6,1,4,2,8,3,9,7,5
2,7,5,9,4,6,1,8,3
9,8,3,1,7,5,6,2,4
