8,5,1,6,4,7,2,3,9
2,3,7,1,5,9,4,6,8
6,9,4,3,8,2,7,5,1
5,4,2,9,3,8,1,7,6
9,7,6,2,1,5,8,4,3
3,1,8,7,6,4,5,9,2
7,6,3,5,2,1,9,8,4
4,2,5,8,9,3,6,1,7
1,8,9,4,7,6,3,2,5
