4,2,5,1,3,9,6,8,7
1,8,9,4,7,6,2,5,3
3,7,6,5,8,2,9,1,4
2,5,7,8,1,4,3,6,9
6,1,3,9,2,7,8,4,5
8,9,4,6,5,3,7,2,1
9,4,2,7,6,1,5,3,8
5,6,1,3,9,8,4,7,2
7,3,8,2,4,5,1,9,6
