1,0,0,0,0,4,0,0,6
0,0,0,0,0,1,0,2,4
6,0,0,0,2,0,5,1,0
0,0,0,7,0,0,0,0,0
0,0,1,0,9,0,0,0,0
2,0,4,0,0,0,0,0,0
0,0,9,6,5,0,7,0,0
0,5,0,2,1,0,0,0,8
7,0,0,4,0,0,0,0,0
