9,8,2,7,1,3,5,6,4
7,5,3,9,6,4,2,1,8
4,1,6,2,5,8,9,3,7
1,3,7,5,2,6,8,4,9
2,4,8,3,9,1,7,5,6
5,6,9,8,4,7,1,2,3
8,9,5,6,3,2,4,7,1
3,2,4,1,7,9,6,8,5
6,7,1,4,8,5,3,9,2
