5,1,8,9,2,4,3,7,6
6,2,7,8,1,3,9,4,5
3,4,9,7,6,5,2,1,8
8,9,4,1,3,7,5,6,2
2,5,6,4,9,8,1,3,7
7,3,1,2,5,6,8,9,4
4,8,5,3,7,1,6,2,9
9,6,3,5,4,2,7,8,1
1,7,2,6,8,9,4,5,3
