1,3,7,5,4,8,6,9,2
6,8,2,1,9,3,4,5,7
4,9,5,2,7,6,8,3,1
8,2,3,4,6,7,9,1,5
9,5,4,8,3,1,7,2,6
7,6,1,9,2,5,3,4,8
3,4,8,7,5,2,1,6,9
5,7,6,3,1,9,2,8,4
2,1,9,6,8,4,5,7,3
