6,8,1,5,4,2,7,9,3
3,9,7,8,6,1,2,5,4
4,5,2,3,9,7,8,6,1
7,4,8,9,1,6,3,2,5
5,6,9,4,2,3,1,7,8
2,1,3,7,8,5,6,4,9
8,7,5,6,3,9,4,1,2
1,3,6,2,5,4,9,8,7
9,2,4,1,7,8,5,3,6
