0,0,9,4,0,3,0,7,0
0,0,0,0,0,0,1,0,2
0,0,0,0,1,6,0,0,0
0,0,0,0,0,4,2,1,0
7,0,0,0,5,0,3,0,0
2,1,0,0,0,0,0,0,9
0,0,0,3,6,0,0,0,0
0,0,0,0,0,2,4,3,0
0,0,1,0,0,0,5,0,7
