3,6,5,8,9,1,7,2,4
4,9,2,6,5,7,1,3,8
7,1,8,4,2,3,5,6,9
5,2,3,1,7,4,8,9,6
1,4,6,9,8,2,3,7,5
8,7,9,5,3,6,4,1,2
2,5,4,7,1,9,6,8,3
9,8,1,3,6,5,2,4,7
6,3,7,2,4,8,9,5,1
