3,5,4,1,9,8,2,6,7
7,6,1,4,3,2,9,8,5
9,2,8,5,6,7,4,1,3
6,3,7,2,1,5,8,9,4
8,1,5,3,4,9,7,2,6
2,4,9,7,8,6,5,3,1
1,7,3,8,2,4,6,5,9
4,9,2,6,5,3,1,7,8
5,8,6,9,7,1,3,4,2
