2,8,5,1,4,9,6,3,7
1,3,4,6,7,2,9,5,8
6,7,9,3,5,8,4,1,2
4,9,2,7,6,3,1,8,5
7,1,6,9,8,5,2,4,3
3,5,8,2,1,4,7,9,6
8,2,1,5,9,7,3,6,4
9,4,7,8,3,6,5,2,1
5,6,3,4,2,1,8,7,9
