2,5,3,1,9,7,8,6,4
8,1,9,2,6,4,3,7,5
4,6,7,3,5,8,2,9,1
1,4,8,9,2,6,5,3,7
5,9,2,8,7,3,1,4,6
3,7,6,5,4,1,9,8,2
6,3,1,4,8,2,7,5,9
9,8,4,7,1,5,6,2,3
7,2,5,6,3,9,4,1,8
