3,1,2,9,8,5,7,6,4
4,5,8,6,2,7,1,3,9
9,7,6,3,1,4,5,2,8
8,2,7,1,6,3,4,9,5
1,4,3,5,9,8,6,7,2
5,6,9,4,7,2,3,8,1
2,8,1,7,5,6,9,4,3
7,3,5,8,4,9,2,1,6
6,9,4,2,3,1,8,5,7
