6,2,1,7,5,4,8,3,9
3,7,8,1,2,9,6,4,5
4,9,5,3,8,6,1,2,7
5,3,2,9,4,1,7,6,8
8,6,7,5,3,2,9,1,4
9,1,4,8,6,7,3,5,2
1,8,6,2,9,5,4,7,3
2,4,9,6,7,3,5,8,1
7,5,3,4,1,8,2,9,6
