0,0,0,0,0,9,6,0,0
0,0,9,4,7,6,2,0,0
3,0,0,5,0,0,0,1,0
0,0,0,0,0,0,0,0,9
0,0,0,0,2,0,0,4,5
0,9,0,6,0,3,0,0,1
0,0,0,7,0,0,0,0,0
5,0,0,0,0,0,0,0,2
7,3,0,0,4,5,0,0,0
