5,1,6,9,2,4,7,8,3
8,2,4,6,3,7,1,9,5
3,9,7,8,1,5,4,2,6
2,7,9,3,5,8,6,1,4
4,5,8,2,6,1,9,3,7
6,3,1,4,7,9,8,5,2
7,8,3,1,4,2,5,6,9
9,6,5,7,8,3,2,4,1
1,4,2,5,9,6,3,7,8
