5,8,6,4,3,7,1,9,2
7,1,4,5,2,9,3,6,8
3,9,2,1,8,6,5,4,7
2,3,5,6,9,1,7,8,4
9,4,7,8,5,2,6,3,1
8,6,1,7,4,3,9,2,5
4,2,9,3,1,5,8,7,6
6,5,8,9,7,4,2,1,3
1,7,3,2,6,8,4,5,9
