9,4,6,7,3,2,8,1,5
2,7,1,8,6,5,9,4,3
8,3,5,9,1,4,6,7,2
6,1,9,4,8,3,5,2,7
5,2,3,1,7,6,4,8,9
7,8,4,5,2,9,1,3,6
1,9,7,2,5,8,3,6,4
4,6,2,3,9,1,7,5,8
3,5,8,6,4,7,2,9,1
