1,2,5,3,7,4,8,9,6
9,8,7,5,6,1,3,2,4
6,4,3,9,2,8,5,1,7
3,9,8,7,4,6,2,5,1
5,6,1,8,9,2,4,7,3
2,7,4,1,3,5,6,8,9
8,1,9,6,5,3,7,4,2
4,5,6,2,1,7,9,3,8
7,3,2,4,8,9,1,6,5
