9,3,7,2,6,1,5,8,4
6,2,1,8,5,4,7,9,3
8,5,4,7,3,9,2,1,6
2,7,5,3,4,8,9,6,1
4,9,8,5,1,6,3,2,7
1,6,3,9,7,2,8,4,5
3,4,9,6,8,5,1,7,2
7,1,2,4,9,3,6,5,8
5,8,6,1,2,7,4,3,9
