9,1,2,4,7,8,5,3,6
3,5,4,2,1,6,8,7,9
6,8,7,9,3,5,1,4,2
1,3,8,7,2,4,6,9,5
4,2,9,6,5,1,7,8,3
7,6,5,8,9,3,4,2,1
2,9,6,5,4,7,3,1,8
5,4,1,3,8,9,2,6,7
8,7,3,1,6,2,9,5,4
