3,9,2,8,4,7,5,6,1
5,1,6,9,2,3,8,7,4
8,4,7,6,1,5,2,3,9
1,2,3,4,7,8,6,9,5
6,5,9,1,3,2,4,8,7
4,7,8,5,9,6,3,1,2
9,6,1,2,8,4,7,5,3
7,8,4,3,5,1,9,2,6
2,3,5,7,6,9,1,4,8
