0,0,1,0,0,2,7,0,0
3,9,0,0,0,1,2,0,0
4,5,0,0,9,0,0,0,1
7,4,8,9,0,0,0,0,0
0,0,9,0,2,0,0,0,0
0,1,0,7,0,0,0,0,0
0,0,0,0,0,0,0,0,0
0,3,0,0,0,0,9,8,0
0,2,0,1,0,8,5,3,0
