0,0,0,0,7,0,0,4,0
0,0,0,0,0,0,0,0,0
9,0,7,6,0,0,1,0,0
6,0,0,0,0,9,0,7,0
0,0,1,2,0,0,9,6,0
4,0,0,0,0,6,0,0,5
7,2,0,0,0,0,0,5,0
0,0,6,0,0,5,0,2,3
0,0,5,1,0,0,0,0,7
