6,7,8,4,3,5,9,2,1
3,9,2,8,1,7,4,5,6
1,5,4,2,9,6,3,7,8
5,4,7,9,6,1,8,3,2
9,8,6,3,2,4,7,1,5
2,3,1,5,7,8,6,4,9
8,1,9,7,4,2,5,6,3
7,2,3,6,5,9,1,8,4
4,6,5,1,8,3,2,9,7
