4,6,1,2,9,8,5,3,7
9,5,8,3,4,7,6,2,1
2,3,7,5,1,6,9,4,8
6,8,5,7,3,4,1,9,2
1,7,4,9,6,2,8,5,3
3,2,9,1,8,5,4,7,6
5,4,3,8,2,1,7,6,9
8,9,6,4,7,3,2,1,5
7,1,2,6,5,9,3,8,4
