0,2,0,0,0,0,8,0,0
0,0,0,0,9,0,0,0,0
5,7,8,0,0,0,2,0,0
0,0,0,0,0,7,0,9,0
0,4,0,1,0,0,0,8,0
0,1,6,0,8,0,0,5,0
4,0,0,0,0,5,0,0,0
0,0,5,2,0,0,9,0,1
6,9,2,0,0,0,0,0,0
