0,0,2,7,0,0,0,6,4
7,0,0,0,0,4,0,0,8
0,1,0,2,0,0,0,3,0
0,0,7,0,0,6,0,4,0
2,0,0,0,0,0,0,0,0
0,0,9,0,0,7,1,2,0
8,0,0,0,3,2,0,7,1
3,0,0,0,0,0,0,0,0
0,0,0,4,8,0,0,0,0
