9,7,3,5,8,6,4,2,1
8,5,6,1,2,4,7,3,9
1,4,2,9,7,3,8,6,5
5,2,1,3,4,8,9,7,6
4,6,8,7,5,9,3,1,2
7,3,9,6,1,2,5,8,4
6,9,5,2,3,7,1,4,8
3,1,4,8,6,5,2,9,7
2,8,7,4,9,1,6,5,3
