4,8,1,9,7,2,3,5,6
9,7,2,6,3,5,4,1,8
5,6,3,4,8,1,9,7,2
7,1,6,2,5,3,8,9,4
8,4,5,1,9,6,2,3,7
3,2,9,8,4,7,1,6,5
1,5,7,3,2,8,6,4,9
6,9,8,5,1,4,7,2,3
2,3,4,7,6,9,5,8,1
