3,0,2,8,0,7,0,0,1
0,0,0,0,2,0,8,7,0
0,4,0,0,0,0,0,3,0
0,0,0,0,0,0,0,0,0
0,0,9,1,3,2,0,0,0
0,0,8,0,0,6,0,1,2
0,6,0,0,0,0,7,0,0
0,0,0,3,0,1,9,0,6
0,0,0,7,0,9,0,0,0
