3,6,7,1,2,8,4,5,9
5,2,4,9,7,6,3,1,8
1,8,9,5,3,4,7,6,2
2,5,8,7,6,9,1,3,4
4,7,1,3,8,5,2,9,6
9,3,6,2,4,1,8,7,5
6,1,2,4,5,3,9,8,7
7,9,5,8,1,2,6,4,3
8,4,3,6,9,7,5,2,1
