2,8,9,4,6,7,3,5,1
3,1,5,2,8,9,4,7,6
6,7,4,3,1,5,2,9,8
7,2,1,6,5,3,9,8,4
4,6,3,7,9,8,1,2,5
9,5,8,1,4,2,6,3,7
1,3,2,8,7,4,5,6,9
5,4,7,9,3,6,8,1,2
8,9,6,5,2,1,7,4,3
