5,1,6,8,2,4,7,3,9
9,8,4,6,7,3,2,5,1
7,3,2,9,1,5,8,6,4
3,6,1,7,5,9,4,2,8
2,7,5,4,3,8,9,1,6
8,4,9,1,6,2,5,7,3
1,2,8,5,9,6,3,4,7
6,9,3,2,4,7,1,8,5
4,5,7,3,8,1,6,9,2
