0,6,1,0,0,7,0,0,0
9,0,4,0,0,1,0,0,0
0,5,8,0,9,0,1,6,0
0,0,0,0,0,0,0,0,0
6,8,0,0,0,0,0,5,0
0,0,0,4,5,6,0,0,0
0,0,0,0,0,0,4,0,7
5,0,0,0,1,0,0,0,0
0,0,0,3,0,9,8,0,0
