3,8,1,4,5,7,9,6,2
2,6,9,3,8,1,5,7,4
5,4,7,2,6,9,1,3,8
4,2,5,1,7,6,3,8,9
1,3,8,9,2,4,6,5,7
9,7,6,8,3,5,4,2,1
8,9,2,6,1,3,7,4,5
6,5,4,7,9,8,2,1,3
7,1,3,5,4,2,8,9,6
