7,8,5,9,4,3,2,1,6
9,6,4,7,2,1,3,8,5
3,2,1,8,5,6,4,9,7
1,4,7,5,6,8,9,2,3
2,5,9,1,3,7,6,4,8
8,3,6,2,9,4,5,7,1
4,1,3,6,7,2,8,5,9
6,9,8,4,1,5,7,3,2
5,7,2,3,8,9,1,6,4
