8,9,6,1,5,2,4,3,7
1,5,2,4,3,7,6,8,9
7,4,3,6,9,8,1,5,2
9,7,8,3,2,1,5,6,4
6,1,4,5,8,9,2,7,3
3,2,5,7,4,6,8,9,1
2,8,1,9,7,5,3,4,6
4,6,7,8,1,3,9,2,5
5,3,9,2,6,4,7,1,8
