8,7,1,3,5,9,4,6,2
2,3,9,6,7,4,5,1,8
6,4,5,8,2,1,3,9,7
3,9,2,7,4,5,6,8,1
7,1,8,2,3,6,9,4,5
4,5,6,9,1,8,7,2,3
9,2,4,5,8,7,1,3,6
1,8,7,4,6,3,2,5,9
5,6,3,1,9,2,8,7,4
