3,2,9,5,7,1,8,4,6
1,6,4,8,9,2,5,7,3
5,7,8,3,4,6,2,1,9
8,5,3,6,2,7,1,9,4
9,4,7,1,5,3,6,8,2
2,1,6,4,8,9,3,5,7
4,3,1,9,6,5,7,2,8
7,8,5,2,3,4,9,6,1
6,9,2,7,1,8,4,3,5
