2,8,4,5,6,9,7,1,3
5,7,9,3,2,1,8,6,4
1,6,3,8,7,4,5,2,9
9,2,7,1,4,3,6,8,5
3,5,6,9,8,2,4,7,1
8,4,1,6,5,7,9,3,2
4,1,8,7,3,5,2,9,6
6,9,2,4,1,8,3,5,7
7,3,5,2,9,6,1,4,8
