9,3,7,0,0,0,5,0,0
0,2,1,0,0,4,0,0,0
0,5,4,0,0,0,0,1,6
0,0,0,3,0,0,9,0,0
0,0,0,0,1,0,3,0,0
0,0,0,0,0,2,0,4,0
0,0,9,0,0,5,1,7,0
0,0,0,4,0,3,0,5,0
0,0,0,1,0,0,0,0,9
