8,7,1,2,5,9,3,4,6
6,5,3,8,4,7,1,2,9
9,2,4,3,1,6,5,7,8
1,3,8,6,7,4,9,5,2
4,9,2,5,3,8,6,1,7
7,6,5,1,9,2,8,3,4
2,1,9,7,8,5,4,6,3
3,4,7,9,6,1,2,8,5
5,8,6,4,2,3,7,9,1
