1,5,9,3,4,7,6,2,8
2,7,4,6,8,5,1,9,3
3,6,8,9,2,1,4,7,5
9,1,5,4,7,6,3,8,2
8,2,6,5,9,3,7,4,1
4,3,7,2,1,8,5,6,9
7,9,2,1,5,4,8,3,6
6,4,1,8,3,2,9,5,7
5,8,3,7,6,9,2,1,4
