9,1,5,2,6,7,4,8,3
4,6,3,8,1,5,9,2,7
7,8,2,3,4,9,6,1,5
6,4,7,5,8,2,1,3,9
3,9,8,1,7,4,2,5,6
5,2,1,6,9,3,8,7,4
8,5,9,7,2,6,3,4,1
1,3,6,4,5,8,7,9,2
2,7,4,9,3,1,5,6,8
