2,6,1,8,3,7,5,4,9
9,3,4,5,6,1,7,8,2
7,5,8,2,9,4,1,6,3
4,2,5,9,8,3,6,7,1
6,8,9,1,7,2,3,5,4
3,1,7,4,5,6,2,9,8
8,9,3,6,2,5,4,1,7
5,4,2,7,1,8,9,3,6
1,7,6,3,4,9,8,2,5
