2,1,3,4,6,9,8,5,7
5,6,8,2,7,1,9,4,3
9,7,4,8,5,3,6,1,2
3,9,7,1,2,4,5,6,8
8,2,1,5,3,6,7,9,4
4,5,6,7,9,8,2,3,1
7,3,9,6,1,2,4,8,5
6,8,2,3,4,5,1,7,9
1,4,5,9,8,7,3,2,6
