8,1,6,2,5,7,3,4,9
3,7,2,4,9,6,8,5,1
5,4,9,8,1,3,7,2,6
9,6,3,7,8,4,5,1,2
1,5,7,9,3,2,4,6,8
2,8,4,1,6,5,9,3,7
4,2,1,3,7,8,6,9,5
6,3,8,5,2,9,1,7,4
7,9,5,6,4,1,2,8,3
