5,9,2,3,8,1,6,4,7
4,7,1,9,6,2,8,5,3
8,3,6,4,7,5,9,1,2
6,4,3,2,1,8,7,9,5
7,1,8,5,3,9,2,6,4
2,5,9,6,4,7,3,8,1
3,6,5,7,9,4,1,2,8
1,2,7,8,5,6,4,3,9
9,8,4,1,2,3,5,7,6
