0,0,1,2,5,0,0,0,6
0,0,0,8,0,7,0,0,0
0,0,0,3,0,6,5,7,0
0,0,8,0,0,0,0,5,2
0,9,0,0,3,0,0,0,7
0,6,0,1,0,0,8,3,0
0,1,9,0,0,0,0,0,0
3,0,0,0,0,0,2,8,5
0,0,0,0,0,0,7,0,0
