5,4,3,9,7,2,6,1,8
2,7,1,6,5,8,4,3,9
9,8,6,4,1,3,2,7,5
3,6,5,8,4,9,1,2,7
4,1,2,5,6,7,9,8,3
7,9,8,3,2,1,5,6,4
1,5,4,7,3,6,8,9,2
8,2,7,1,9,5,3,4,6
6,3,9,2,8,4,7,5,1
