8,9,2,6,3,5,1,4,7
7,6,1,4,8,9,2,3,5
4,5,3,1,7,2,9,8,6
6,1,5,3,9,4,8,7,2
9,7,8,2,5,6,4,1,3
3,2,4,7,1,8,5,6,9
5,3,7,8,2,1,6,9,4
2,8,6,9,4,7,3,5,1
1,4,9,5,6,3,7,2,8
