0,0,0,0,0,0,0,6,4
8,1,9,2,0,0,0,0,5
0,0,7,0,0,0,0,0,0
0,0,0,0,0,6,5,0,0
5,0,2,8,7,0,0,0,6
0,7,0,0,0,1,0,0,0
6,0,0,0,8,0,0,0,0
0,8,0,0,1,5,0,0,0
0,0,0,0,0,0,4,1,0
