0,0,0,0,0,3,8,0,0
0,0,0,0,2,0,0,9,1
0,8,0,0,0,9,4,2,7
0,7,3,0,0,0,0,4,0
0,2,0,9,0,0,0,7,0
1,0,0,0,0,0,0,0,0
0,9,5,1,0,0,0,3,0
2,3,4,0,0,7,0,0,0
0,0,8,0,0,0,0,0,0
