1,4,5,6,7,9,8,2,3
6,2,3,1,8,5,4,9,7
9,8,7,3,4,2,6,5,1
3,1,8,4,5,7,2,6,9
7,6,4,9,2,3,1,8,5
5,9,2,8,6,1,3,7,4
4,5,9,2,1,8,7,3,6
8,7,6,5,3,4,9,1,2
2,3,1,7,9,6,5,4,8
