0,2,4,0,0,0,0,5,0
0,3,0,0,0,0,0,0,0
0,0,0,3,9,0,0,6,2
0,0,6,0,2,0,0,0,9
0,1,0,0,0,0,0,0,4
5,4,7,0,0,0,0,0,0
1,0,0,4,0,0,0,0,3
0,0,0,9,0,5,0,1,6
0,9,0,0,0,0,0,0,0
