1,9,7,6,4,8,2,5,3
6,4,2,5,7,3,8,9,1
3,5,8,1,2,9,7,6,4
7,6,1,2,9,5,4,3,8
5,2,9,3,8,4,1,7,6
4,8,3,7,6,1,9,2,5
9,3,6,4,1,2,5,8,7
2,1,5,8,3,7,6,4,9
8,7,4,9,5,6,3,1,2
