1,0,0,0,0,0,9,0,4
0,7,0,9,4,0,5,2,0
0,0,0,0,3,2,0,0,0
2,0,8,0,0,4,0,0,0
0,9,0,0,8,0,0,0,0
0,0,5,7,0,0,0,1,8
0,0,0,0,0,0,0,4,7
0,0,0,0,0,8,0,0,0
7,0,0,0,0,9,3,0,0
