0,0,0,3,0,8,0,0,2
0,0,8,9,0,2,4,0,0
0,0,5,0,0,0,8,7,0
0,0,0,0,3,0,0,9,0
0,7,6,0,0,4,0,8,3
0,0,2,0,0,0,0,0,0
8,0,0,0,0,0,0,0,5
0,6,0,0,0,0,0,4,0
5,9,3,0,0,0,0,0,0
