3,7,9,5,1,8,2,6,4
6,2,1,3,4,9,5,8,7
5,4,8,6,7,2,9,1,3
4,6,5,7,2,3,1,9,8
7,9,3,8,6,1,4,5,2
1,8,2,4,9,5,3,7,6
9,1,6,2,3,7,8,4,5
8,3,4,1,5,6,7,2,9
2,5,7,9,8,4,6,3,1
