9,2,7,4,3,5,6,8,1
8,4,3,1,2,6,5,9,7
5,6,1,8,7,9,4,2,3
3,9,6,2,5,1,8,7,4
4,8,2,6,9,7,3,1,5
1,7,5,3,4,8,2,6,9
7,3,4,9,6,2,1,5,8
2,1,9,5,8,4,7,3,6
6,5,8,7,1,3,9,4,2
