1,8,2,6,3,5,7,4,9
7,6,5,9,4,8,3,2,1
9,4,3,2,7,1,6,5,8
8,9,1,3,5,2,4,7,6
2,3,7,4,9,6,8,1,5
6,5,4,1,8,7,2,9,3
5,2,6,7,1,3,9,8,4
3,1,9,8,2,4,5,6,7
4,7,8,5,6,9,1,3,2
