0,3,0,0,0,1,7,6,0
0,0,0,0,6,0,9,0,5
0,0,0,4,7,0,1,0,0
0,0,4,1,0,0,0,3,0
0,0,7,5,8,0,6,0,0
8,1,3,0,0,0,0,0,0
0,0,1,0,0,0,0,0,0
0,0,0,0,9,0,0,0,0
0,5,0,0,0,8,0,0,0
