0,3,0,0,0,2,0,0,0
0,6,0,0,0,0,0,0,0
4,0,9,0,3,0,0,0,7
1,2,0,0,0,0,0,0,0
0,0,7,0,0,9,0,6,0
0,0,3,0,7,0,0,0,0
0,0,0,0,9,0,0,8,1
0,8,1,0,0,6,3,0,2
0,0,0,7,8,0,0,4,0
