0,0,0,0,5,0,0,0,0
0,0,0,0,0,0,2,0,8
0,0,0,8,0,0,4,0,3
0,0,0,0,3,0,0,0,1
0,6,0,0,4,7,0,0,2
4,0,0,2,6,0,7,0,0
2,1,0,5,0,0,0,3,4
0,0,4,0,0,0,1,0,7
3,0,0,0,8,0,0,0,0
