5,6,3,1,8,4,9,2,7
7,4,1,2,9,3,6,5,8
8,9,2,6,7,5,1,3,4
2,8,9,3,4,1,7,6,5
1,7,6,9,5,8,2,4,3
3,5,4,7,2,6,8,1,9
4,1,5,8,6,7,3,9,2
9,3,7,5,1,2,4,8,6
6,2,8,4,3,9,5,7,1
