5,4,1,7,8,2,3,9,6
3,7,6,9,1,5,8,2,4
2,9,8,4,3,6,1,5,7
4,1,5,3,2,8,6,7,9
9,3,7,6,5,4,2,8,1
8,6,2,1,9,7,5,4,3
1,5,3,8,7,9,4,6,2
7,2,4,5,6,1,9,3,8
6,8,9,2,4,3,7,1,5
