8,2,6,5,7,4,1,9,3
9,3,7,6,1,8,4,5,2
4,5,1,3,9,2,7,6,8
5,7,3,9,2,1,8,4,6
6,4,9,8,3,7,2,1,5
1,8,2,4,5,6,3,7,9
2,9,5,1,4,3,6,8,7
7,6,4,2,8,9,5,3,1
3,1,8,7,6,5,9,2,4
