0,9,8,0,0,0,0,0,4
0,0,4,0,0,0,6,8,0
1,0,0,0,0,0,0,0,0
0,0,0,0,0,0,0,9,1
0,4,0,0,0,0,7,0,6
0,0,7,9,0,0,5,0,0
0,0,2,4,6,0,0,0,7
0,0,0,5,1,0,8,0,0
0,8,6,0,0,7,0,0,5
