5,6,4,9,7,2,1,8,3
7,3,8,5,1,6,4,9,2
2,9,1,3,8,4,5,6,7
8,1,9,2,4,3,6,7,5
4,7,6,8,5,1,2,3,9
3,2,5,6,9,7,8,4,1
9,5,2,4,3,8,7,1,6
1,4,3,7,6,5,9,2,8
6,8,7,1,2,9,3,5,4
