8,7,3,2,4,5,9,6,1
6,1,5,9,3,7,2,8,4
2,4,9,6,8,1,5,3,7
9,5,7,8,2,4,6,1,3
4,6,1,3,7,9,8,2,5
3,8,2,5,1,6,7,4,9
7,3,6,1,9,8,4,5,2
1,9,8,4,5,2,3,7,6
5,2,4,7,6,3,1,9,8
