9,6,3,4,5,2,7,8,1
2,5,8,9,1,7,4,3,6
7,4,1,6,8,3,9,2,5
4,3,5,2,9,6,1,7,8
1,7,9,5,4,8,2,6,3
6,8,2,7,3,1,5,4,9
8,1,7,3,2,5,6,9,4
3,2,4,1,6,9,8,5,7
5,9,6,8,7,4,3,1,2
