3,4,7,2,5,9,6,8,1
6,2,9,3,1,8,7,5,4
8,1,5,6,7,4,3,9,2
9,7,4,1,2,6,8,3,5
2,5,3,9,8,7,1,4,6
1,6,8,4,3,5,2,7,9
7,9,6,8,4,1,5,2,3
5,3,1,7,9,2,4,6,8
4,8,2,5,6,3,9,1,7
