5,2,6,3,7,9,1,8,4
4,3,8,5,1,6,7,9,2
7,9,1,4,2,8,5,3,6
1,7,5,2,8,3,4,6,9
9,8,2,6,4,7,3,1,5
3,6,4,9,5,1,8,2,7
8,4,3,7,9,2,6,5,1
2,1,7,8,6,5,9,4,3
6,5,9,1,3,4,2,7,8
