8,1,7,2,3,9,4,5,6
9,6,2,5,1,4,8,7,3
4,5,3,6,7,8,9,2,1
3,7,1,4,5,2,6,9,8
6,2,9,3,8,7,5,1,4
5,4,8,9,6,1,2,3,7
2,3,4,7,9,6,1,8,5
1,9,5,8,4,3,7,6,2
7,8,6,1,2,5,3,4,9
