6,3,2,8,9,7,5,4,1
1,4,9,6,5,3,7,8,2
8,7,5,4,1,2,6,3,9
2,5,3,7,6,4,1,9,8
4,9,8,5,2,1,3,7,6
7,6,1,9,3,8,4,2,5
5,2,7,1,4,9,8,6,3
9,1,4,3,8,6,2,5,7
3,8,6,2,7,5,9,1,4
