1,0,0,6,4,0,2,5,0
6,4,0,0,0,0,8,0,0
0,0,0,0,0,0,7,0,0
0,0,1,2,0,5,0,3,8
5,0,0,0,0,4,1,0,0
0,8,0,7,0,0,0,0,0
0,0,6,0,0,0,0,0,0
2,1,0,8,0,7,0,0,0
8,7,0,0,0,0,0,1,0
