0,0,0,9,1,0,0,0,0
0,0,0,0,7,0,0,5,0
0,0,0,6,0,4,0,0,0
0,0,4,0,6,0,0,7,2
0,7,0,0,3,1,0,0,0
5,1,0,0,0,0,0,0,6
0,0,0,2,5,9,3,0,0
0,0,0,0,0,7,0,9,5
0,2,0,0,0,0,0,0,0
