0,4,0,0,0,0,0,0,0
6,3,0,0,5,4,9,0,0
0,0,1,6,0,0,0,0,0
0,0,0,4,0,0,0,6,8
1,0,0,8,0,9,0,2,3
0,0,5,0,0,0,0,0,0
4,2,6,0,0,8,0,9,0
0,0,0,3,0,0,0,0,0
8,0,0,9,0,2,0,0,0
