7,8,1,4,2,9,5,6,3
5,4,3,8,6,1,9,7,2
6,2,9,7,5,3,1,8,4
1,7,4,5,8,2,6,3,9
2,6,8,9,3,7,4,5,1
3,9,5,1,4,6,7,2,8
8,5,6,2,9,4,3,1,7
9,1,2,3,7,5,8,4,6
4,3,7,6,1,8,2,9,5
