8,0,3,2,0,0,0,0,0
0,0,0,0,0,0,0,0,0
0,4,0,6,8,1,0,0,0
9,5,0,0,0,0,0,1,3
4,0,0,3,0,9,8,0,5
0,0,2,0,0,6,0,4,0
0,0,6,0,0,0,4,0,0
1,0,0,4,5,2,0,0,0
0,2,0,0,0,3,0,0,0
