0,6,0,0,9,0,0,1,0
0,0,4,0,0,2,7,3,0
1,0,0,7,3,0,0,5,0
0,0,0,0,0,0,0,0,0
0,0,2,0,7,4,0,0,0
9,0,0,0,0,0,0,0,0
3,7,0,0,2,0,1,9,0
0,0,1,0,0,0,0,0,0
0,4,0,6,0,0,0,0,2
