4,3,9,8,5,1,7,6,2
1,7,8,3,6,2,9,4,5
6,2,5,4,7,9,1,8,3
5,6,4,1,2,7,8,3,9
2,9,7,5,8,3,6,1,4
8,1,3,9,4,6,5,2,7
9,4,1,6,3,5,2,7,8
7,8,6,2,9,4,3,5,1
3,5,2,7,1,8,4,9,6
