3,0,7,2,0,9,0,0,1
6,0,0,3,0,0,0,0,0
0,0,0,0,0,0,0,9,2
0,7,0,0,0,0,0,3,0
2,5,0,9,0,0,1,0,0
1,6,0,4,3,0,0,7,0
0,0,0,0,0,1,0,0,3
5,0,0,0,0,0,0,6,0
0,0,0,0,0,0,9,0,7
