8,4,9,6,2,1,7,5,3
3,2,1,7,5,9,8,4,6
7,5,6,4,3,8,9,1,2
9,3,5,1,7,6,4,2,8
6,7,8,5,4,2,1,3,9
2,1,4,8,9,3,6,7,5
4,8,7,2,6,5,3,9,1
5,6,3,9,1,7,2,8,4
1,9,2,3,8,4,5,6,7
