2,9,6,8,4,3,1,7,5
1,8,3,5,9,7,6,4,2
5,4,7,6,2,1,9,8,3
9,6,1,3,8,2,7,5,4
7,5,2,4,6,9,8,3,1
8,3,4,1,7,5,2,9,6
4,1,9,2,5,8,3,6,7
6,2,8,7,3,4,5,1,9
3,7,5,9,1,6,4,2,8
