7,2,4,8,1,6,9,3,5
9,3,1,5,7,4,6,8,2
5,8,6,2,3,9,7,4,1
1,7,5,3,6,2,8,9,4
2,6,9,7,4,8,1,5,3
8,4,3,9,5,1,2,6,7
4,9,7,1,8,5,3,2,6
6,1,2,4,9,3,5,7,8
3,5,8,6,2,7,4,1,9
