0,0,0,0,2,0,8,0,0
0,0,2,9,1,0,0,3,0
0,0,0,0,0,8,0,9,0
5,0,0,0,6,3,0,0,1
3,0,8,0,0,0,4,0,0
0,0,0,1,9,0,0,0,0
0,0,0,0,3,0,0,4,0
0,5,0,0,0,0,0,1,0
4,0,0,6,0,2,0,8,0
