7,3,8,4,6,2,1,5,9
2,6,5,9,1,7,4,3,8
4,1,9,8,3,5,6,2,7
1,2,6,3,5,8,7,9,4
5,4,7,1,2,9,8,6,3
8,9,3,6,7,4,2,1,5
6,7,4,2,9,3,5,8,1
9,8,1,5,4,6,3,7,2
3,5,2,7,8,1,9,4,6
