0,0,0,2,0,9,0,0,0
9,0,2,0,1,4,0,0,3
0,5,0,0,7,0,0,0,1
0,7,1,0,5,0,6,0,0
6,0,0,0,0,0,0,0,0
0,0,0,0,0,0,0,0,0
2,3,0,7,9,0,1,0,0
0,0,0,0,4,3,7,6,0
0,0,0,1,0,0,0,4,0
