0,0,0,5,0,0,0,0,0
0,0,0,0,0,0,1,0,8
0,0,0,1,0,6,0,0,0
0,1,0,0,0,7,0,5,0
5,2,0,0,1,0,4,0,6
0,0,0,8,0,0,0,9,0
1,8,0,6,5,0,0,2,0
0,4,0,0,0,0,6,0,0
0,0,2,0,0,9,8,0,0
