3,2,4,8,7,1,5,6,9
9,7,8,6,2,5,4,1,3
1,6,5,3,9,4,7,8,2
5,1,6,2,8,3,9,7,4
7,8,3,1,4,9,6,2,5
4,9,2,5,6,7,1,3,8
6,3,9,4,1,8,2,5,7
8,4,1,7,5,2,3,9,6
2,5,7,9,3,6,8,4,1
