2,1,5,9,8,7,6,4,3
8,7,3,4,5,6,2,1,9
4,9,6,3,2,1,8,7,5
1,5,8,6,4,3,7,9,2
9,6,4,8,7,2,3,5,1
7,3,2,5,1,9,4,6,8
3,4,7,1,9,8,5,2,6
5,8,1,2,6,4,9,3,7
6,2,9,7,3,5,1,8,4
