0,0,0,0,0,0,0,0,3
0,0,0,0,0,0,0,1,0
0,0,6,0,2,0,0,0,0
0,5,0,0,4,3,0,9,2
0,0,0,0,7,0,0,5,1
0,3,0,0,0,9,4,0,0
0,4,7,1,0,0,5,2,6
0,0,1,0,0,0,0,0,0
6,2,0,0,3,0,0,0,0
