0,3,0,4,8,0,2,0,0
0,0,0,0,0,1,0,0,7
8,0,0,3,2,0,0,0,0
0,0,0,5,3,4,0,0,0
0,2,0,0,1,0,0,0,0
0,0,0,8,0,0,4,0,5
7,9,0,0,0,0,5,2,0
0,0,0,0,9,0,0,1,0
2,8,0,1,0,0,0,4,0
