6,8,5,1,4,2,9,3,7
1,2,9,7,3,8,4,5,6
4,3,7,5,9,6,1,2,8
5,4,8,6,7,9,3,1,2
7,6,3,2,1,5,8,4,9
9,1,2,3,8,4,6,7,5
3,5,1,9,6,7,2,8,4
8,7,6,4,2,1,5,9,3
2,9,4,8,5,3,7,6,1
