2,1,3,7,5,4,6,9,8
4,9,6,3,8,2,1,5,7
5,7,8,6,1,9,2,4,3
1,8,5,2,6,3,9,7,4
9,2,7,1,4,8,3,6,5
6,3,4,9,7,5,8,2,1
8,4,1,5,2,6,7,3,9
7,6,9,4,3,1,5,8,2
3,5,2,8,9,7,4,1,6
