4,6,5,2,7,3,9,8,1
3,9,8,4,6,1,2,5,7
2,1,7,8,9,5,4,6,3
1,5,2,7,3,9,6,4,8
9,4,6,5,1,8,3,7,2
7,8,3,6,2,4,5,1,9
5,3,4,9,8,7,1,2,6
8,2,1,3,5,6,7,9,4
6,7,9,1,4,2,8,3,5
