7,6,3,4,9,5,2,1,8
5,9,4,1,8,2,7,3,6
1,2,8,7,3,6,4,5,9
4,3,7,8,5,9,6,2,1
6,1,2,3,7,4,9,8,5
9,8,5,2,6,1,3,4,7
3,7,6,5,2,8,1,9,4
2,5,1,9,4,7,8,6,3
8,4,9,6,1,3,5,7,2
