7,8,2,1,6,3,5,4,9
6,3,5,9,4,7,8,2,1
1,9,4,2,8,5,7,6,3
5,1,8,3,7,4,6,9,2
3,7,6,5,9,2,4,1,8
2,4,9,8,1,6,3,7,5
4,5,3,6,2,1,9,8,7
9,2,7,4,5,8,1,3,6
8,6,1,7,3,9,2,5,4
