5,3,9,4,8,7,2,6,1
6,4,2,9,5,1,8,3,7
8,1,7,3,2,6,9,5,4
9,6,8,5,3,4,1,7,2
4,2,5,7,1,9,6,8,3
1,7,3,8,6,2,4,9,5
7,9,1,6,4,3,5,2,8
3,5,4,2,9,8,7,1,6
2,8,6,1,7,5,3,4,9
