6,4,9,3,7,8,1,5,2
7,1,8,9,5,2,4,3,6
2,3,5,4,6,1,8,7,9
4,8,1,6,3,5,2,9,7
9,7,6,2,1,4,5,8,3
3,5,2,7,8,9,6,1,4
8,2,4,1,9,7,3,6,5
1,6,7,5,2,3,9,4,8
5,9,3,8,4,6,7,2,1
