1,3,9,5,2,6,8,7,4
8,4,2,9,1,7,5,3,6
7,6,5,3,4,8,1,9,2
5,9,4,8,6,3,7,2,1
3,1,8,2,7,5,4,6,9
6,2,7,1,9,4,3,5,8
9,8,6,7,3,1,2,4,5
2,5,3,4,8,9,6,1,7
4,7,1,6,5,2,9,8,3
