0,0,0,0,0,2,0,0,0
0,5,0,0,0,0,4,3,0
0,0,0,6,8,3,9,0,0
0,0,0,2,9,6,0,7,0
0,7,0,0,4,8,0,0,0
0,0,0,0,0,0,0,0,9
8,0,0,0,0,5,6,9,0
3,0,0,0,6,9,8,5,7
0,0,0,0,0,0,0,0,2
