3,1,9,5,6,8,4,7,2
5,8,7,2,4,9,1,6,3
4,6,2,7,1,3,5,8,9
1,4,6,8,7,2,3,9,5
8,9,3,4,5,1,6,2,7
7,2,5,9,3,6,8,4,1
6,3,4,1,9,7,2,5,8
2,7,1,6,8,5,9,3,4
9,5,8,3,2,4,7,1,6
