1,2,6,8,5,7,9,3,4
8,7,3,9,4,6,5,2,1
5,4,9,1,3,2,8,7,6
2,1,8,5,6,4,7,9,3
3,9,7,2,8,1,4,6,5
4,6,5,7,9,3,2,1,8
9,8,1,3,2,5,6,4,7
6,3,2,4,7,8,1,5,9
7,5,4,6,1,9,3,8,2
