0,0,0,9,0,3,5,0,0
0,0,0,0,2,0,0,4,0
0,4,0,1,0,0,0,0,7
0,0,0,0,1,0,0,0,4
0,8,0,3,0,5,9,0,0
0,0,0,0,7,8,0,0,0
4,2,0,7,0,0,0,0,0
0,1,9,8,3,0,0,0,0
0,0,0,0,0,0,2,0,9
