2,7,8,6,5,1,4,9,3
9,4,6,2,3,7,8,5,1
1,3,5,4,8,9,2,6,7
3,6,2,7,9,8,1,4,5
7,5,9,1,2,4,6,3,8
4,8,1,5,6,3,9,7,2
8,1,3,9,4,5,7,2,6
5,2,4,8,7,6,3,1,9
6,9,7,3,1,2,5,8,4
