9,4,7,2,8,1,6,3,5
6,3,8,7,5,4,9,1,2
2,5,1,6,9,3,8,7,4
7,9,2,4,3,5,1,6,8
1,6,4,8,7,9,5,2,3
3,8,5,1,2,6,7,4,9
4,2,6,5,1,8,3,9,7
5,1,9,3,4,7,2,8,6
8,7,3,9,6,2,4,5,1
