2,7,1,5,4,8,3,6,9
3,6,5,7,9,2,1,4,8
8,9,4,1,3,6,5,7,2
9,1,8,4,6,7,2,5,3
5,2,7,9,1,3,4,8,6
4,3,6,8,2,5,7,9,1
1,8,3,6,5,4,9,2,7
7,4,9,2,8,1,6,3,5
6,5,2,3,7,9,8,1,4
