0,0,0,5,0,0,0,7,0
0,0,0,2,4,9,0,0,0
4,0,0,0,1,3,0,8,9
0,0,0,0,7,2,0,0,0
0,9,3,0,0,0,0,0,0
0,0,5,0,0,0,0,0,1
0,0,4,1,0,0,0,5,8
2,0,0,0,0,0,9,0,4
0,0,0,3,2,0,7,0,0
