4,1,2,6,9,7,3,8,5
8,9,6,4,5,3,2,7,1
5,3,7,2,1,8,4,6,9
2,8,3,7,4,9,5,1,6
9,6,5,3,8,1,7,2,4
7,4,1,5,2,6,9,3,8
6,7,9,1,3,5,8,4,2
1,2,8,9,7,4,6,5,3
3,5,4,8,6,2,1,9,7
