0,1,3,7,0,0,0,0,0
4,0,6,3,0,0,1,0,0
0,7,0,0,0,9,0,4,0
0,0,0,0,0,0,0,0,0
9,0,0,0,4,0,3,0,5
0,0,0,0,0,0,0,2,0
0,0,1,5,2,0,7,0,0
0,0,0,4,3,0,0,0,2
0,0,0,0,9,0,0,1,6
