4,8,3,9,1,5,6,2,7
2,6,1,8,7,3,9,5,4
7,5,9,6,2,4,8,1,3
3,9,4,5,6,8,1,7,2
6,7,2,4,3,1,5,8,9
5,1,8,7,9,2,4,3,6
1,4,7,2,5,9,3,6,8
8,3,6,1,4,7,2,9,5
9,2,5,3,8,6,7,4,1
