3,5,7,1,2,9,6,4,8
9,1,2,4,6,8,7,3,5
6,8,4,5,7,3,9,1,2
1,4,6,9,8,2,3,5,7
8,2,3,7,1,5,4,9,6
5,7,9,6,3,4,8,2,1
7,3,8,2,4,1,5,6,9
2,6,5,3,9,7,1,8,4
4,9,1,8,5,6,2,7,3
