0,0,0,0,0,0,0,0,0
0,2,0,0,0,1,0,4,9
0,9,0,8,5,0,1,0,0
0,0,0,0,0,9,0,0,6
1,6,0,0,0,0,4,0,0
8,7,0,0,0,0,0,0,0
5,8,7,4,0,0,0,0,0
4,0,0,0,8,0,0,1,2
0,0,0,0,0,0,0,0,0
