2,0,0,0,0,0,0,0,0
0,0,9,0,0,0,2,8,0
0,0,0,0,3,2,9,6,1
0,8,0,0,0,0,0,0,6
3,5,0,0,2,1,0,0,0
1,0,0,0,0,3,0,0,0
0,2,5,0,0,0,4,0,0
9,0,0,0,1,0,0,0,0
0,0,1,0,0,0,8,9,3
