7,5,6,3,9,8,2,4,1
2,1,3,6,4,7,8,9,5
9,8,4,2,5,1,6,3,7
6,3,1,5,8,2,4,7,9
8,2,5,4,7,9,1,6,3
4,7,9,1,3,6,5,2,8
5,4,7,8,6,3,9,1,2
3,6,2,9,1,5,7,8,4
1,9,8,7,2,4,3,5,6
