0,0,6,3,0,0,2,4,1
0,0,0,0,4,0,8,0,0
9,8,0,0,0,0,0,0,0
0,3,1,0,0,0,0,0,0
0,2,0,4,0,0,0,6,3
0,0,0,1,0,6,0,0,0
5,4,0,0,0,0,0,0,0
0,0,2,0,0,5,0,0,0
0,9,8,0,0,0,0,0,6
