8,4,2,7,5,3,9,1,6
1,5,3,6,9,4,2,7,8
6,9,7,8,1,2,4,5,3
7,2,8,9,3,5,6,4,1
9,6,5,1,4,7,3,8,2
4,3,1,2,6,8,7,9,5
2,1,9,5,7,6,8,3,4
5,8,4,3,2,9,1,6,7
3,7,6,4,8,1,5,2,9
