1,7,8,9,4,3,5,6,2
9,6,3,5,2,7,1,4,8
5,4,2,1,8,6,3,9,7
3,5,6,2,1,9,7,8,4
7,8,4,3,6,5,9,2,1
2,9,1,4,7,8,6,5,3
4,2,5,7,9,1,8,3,6
6,1,9,8,3,2,4,7,5
8,3,7,6,5,4,2,1,9
