2,1,4,9,8,6,3,7,5
6,3,9,1,7,5,2,8,4
5,7,8,4,3,2,9,6,1
4,8,2,5,9,7,1,3,6
3,5,6,8,2,1,7,4,9
1,9,7,6,4,3,5,2,8
8,2,5,3,6,9,4,1,7
9,4,3,7,1,8,6,5,2
7,6,1,2,5,4,8,9,3
