6,3,2,4,1,9,8,7,5
9,8,1,6,7,5,4,3,2
5,4,7,2,3,8,6,1,9
8,1,3,9,4,6,5,2,7
2,6,9,3,5,7,1,4,8
7,5,4,1,8,2,9,6,3
3,7,6,8,9,1,2,5,4
1,9,5,7,2,4,3,8,6
4,2,8,5,6,3,7,9,1
