9,7,5,2,8,4,1,3,6
3,8,2,7,6,1,9,5,4
1,4,6,9,5,3,8,7,2
8,6,1,4,7,2,3,9,5
7,5,4,3,9,6,2,1,8
2,3,9,8,1,5,4,6,7
5,9,3,6,2,8,7,4,1
6,2,7,1,4,9,5,8,3
4,1,8,5,3,7,6,2,9
