0,0,0,0,0,0,0,0,4
0,0,0,0,1,0,0,9,0
7,0,0,0,0,0,0,0,0
1,7,0,2,8,0,0,0,9
9,0,2,0,0,7,3,0,0
0,0,0,0,0,0,8,0,0
8,4,0,7,0,2,6,0,1
0,0,0,0,0,0,0,0,0
6,0,0,1,3,0,2,7,0
