2,7,9,8,5,4,3,6,1
3,4,8,6,7,1,9,2,5
6,1,5,2,9,3,8,4,7
4,5,1,9,3,7,6,8,2
7,9,2,4,8,6,1,5,3
8,6,3,5,1,2,7,9,4
1,2,4,3,6,8,5,7,9
9,3,6,7,2,5,4,1,8
5,8,7,1,4,9,2,3,6
