7,5,1,2,9,4,6,3,8
3,2,8,7,6,1,5,4,9
6,9,4,8,5,3,1,2,7
2,4,5,1,7,9,3,8,6
1,6,9,3,2,8,4,7,5
8,7,3,5,4,6,2,9,1
5,8,7,4,1,2,9,6,3
4,3,6,9,8,5,7,1,2
9,1,2,6,3,7,8,5,4
