1,5,9,8,6,2,7,4,3
4,8,2,3,1,7,6,9,5
7,6,3,9,4,5,1,8,2
9,2,5,1,8,4,3,7,6
3,4,7,5,2,6,8,1,9
8,1,6,7,9,3,5,2,4
5,3,1,4,7,9,2,6,8
2,9,8,6,3,1,4,5,7
6,7,4,2,5,8,9,3,1
