7,9,8,6,3,2,1,5,4
2,5,4,1,7,9,6,8,3
1,6,3,8,5,4,2,7,9
8,2,5,7,4,6,3,9,1
9,4,1,3,8,5,7,2,6
6,3,7,9,2,1,5,4,8
5,1,2,4,6,8,9,3,7
4,7,9,5,1,3,8,6,2
3,8,6,2,9,7,4,1,5
