1,8,0,6,0,0,0,4,0
0,0,0,9,0,0,0,0,1
0,4,0,0,0,0,6,0,0
0,9,0,0,0,2,0,7,0
0,0,7,0,0,0,0,1,5
0,0,0,1,0,0,0,0,0
0,2,6,7,0,0,9,0,0
0,0,9,0,2,0,5,6,0
4,0,0,0,0,9,0,0,2
