8,2,6,7,5,3,4,1,9
1,9,3,8,4,6,7,2,5
7,5,4,1,2,9,3,6,8
5,6,2,3,1,4,9,8,7
9,4,1,6,8,7,2,5,3
3,8,7,2,9,5,6,4,1
4,3,5,9,6,8,1,7,2
6,1,9,5,7,2,8,3,4
2,7,8,4,3,1,5,9,6
