9,2,4,6,7,1,3,5,8
6,3,8,5,4,2,1,9,7
7,5,1,3,9,8,4,6,2
3,8,6,1,2,4,5,7,9
2,1,9,7,5,3,6,8,4
5,4,7,8,6,9,2,3,1
1,6,5,4,8,7,9,2,3
4,7,2,9,3,5,8,1,6
8,9,3,2,1,6,7,4,5
