9,1,8,5,7,4,6,2,3
7,6,4,2,3,9,1,8,5
2,3,5,6,8,1,4,9,7
4,7,1,3,9,5,2,6,8
8,9,2,1,6,7,5,3,4
3,5,6,4,2,8,9,7,1
5,8,9,7,1,2,3,4,6
1,2,3,8,4,6,7,5,9
6,4,7,9,5,3,8,1,2
