1,8,4,9,2,5,3,7,6
9,2,5,7,3,6,1,4,8
3,6,7,8,4,1,2,5,9
2,4,1,5,6,8,7,9,3
5,7,8,4,9,3,6,2,1
6,3,9,2,1,7,4,8,5
7,9,6,3,5,2,8,1,4
4,1,2,6,8,9,5,3,7
8,5,3,1,7,4,9,6,2
