1,3,4,5,2,9,8,7,6
5,7,6,3,8,4,2,1,9
8,2,9,7,6,1,4,5,3
4,1,7,6,3,5,9,8,2
2,5,3,4,9,8,1,6,7
9,6,8,2,1,7,5,3,4
6,4,5,1,7,2,3,9,8
7,8,1,9,4,3,6,2,5
3,9,2,8,5,6,7,4,1
