6,2,1,4,5,3,8,7,9
5,4,7,2,9,8,6,3,1
9,3,8,7,1,6,2,5,4
3,7,4,9,6,5,1,8,2
1,9,2,8,4,7,3,6,5
8,6,5,1,3,2,9,4,7
2,1,3,5,8,4,7,9,6
7,5,6,3,2,9,4,1,8
4,8,9,6,7,1,5,2,3
