0,1,8,5,7,0,0,2,3
0,0,0,0,0,9,0,8,0
2,0,0,0,0,1,4,9,0
0,7,0,0,9,0,0,0,0
0,9,0,0,0,0,5,3,4
3,0,0,0,2,0,0,0,1
5,8,0,0,1,0,0,0,0
1,0,0,0,0,0,0,0,0
0,0,7,0,0,0,8,0,0
