0,0,0,8,2,4,0,0,1
6,0,0,0,0,0,0,0,0
0,8,2,0,0,0,0,7,0
7,6,0,2,8,0,0,1,0
2,0,0,0,1,0,6,5,0
0,5,9,4,0,7,0,8,2
9,0,0,0,0,0,0,0,0
8,0,5,7,0,0,0,0,0
0,0,4,0,0,0,0,0,0
