9,7,4,6,8,3,5,2,1
3,1,5,9,4,2,7,6,8
6,2,8,5,1,7,4,3,9
5,9,7,3,6,8,1,4,2
1,8,6,2,9,4,3,5,7
2,4,3,7,5,1,8,9,6
4,6,9,8,7,5,2,1,3
7,5,2,1,3,9,6,8,4
8,3,1,4,2,6,9,7,5
