8,9,3,5,2,6,4,7,1
5,4,1,7,9,8,3,2,6
2,6,7,4,1,3,5,9,8
9,7,8,6,5,2,1,4,3
1,2,5,3,4,7,8,6,9
6,3,4,9,8,1,2,5,7
3,1,9,2,6,5,7,8,4
4,8,2,1,7,9,6,3,5
7,5,6,8,3,4,9,1,2
