5,4,2,7,8,9,1,3,6
9,6,3,4,2,1,8,5,7
8,7,1,3,6,5,4,2,9
1,5,4,9,3,6,2,7,8
3,2,9,5,7,8,6,4,1
7,8,6,2,1,4,5,9,3
4,1,5,6,9,7,3,8,2
2,9,8,1,5,3,7,6,4
6,3,7,8,4,2,9,1,5
