9,8,3,2,1,4,7,6,5
1,4,5,6,7,9,8,3,2
6,2,7,8,5,3,4,9,1
7,9,2,3,6,5,1,8,4
4,5,6,1,2,8,9,7,3
3,1,8,9,4,7,5,2,6
5,7,9,4,3,6,2,1,8
2,3,4,7,8,1,6,5,9
8,6,1,5,9,2,3,4,7
