8,7,5,2,9,4,6,3,1
4,9,6,1,3,7,8,5,2
3,1,2,5,6,8,4,7,9
2,5,8,3,1,6,7,9,4
6,4,1,7,2,9,5,8,3
9,3,7,4,8,5,1,2,6
5,2,3,8,4,1,9,6,7
7,6,4,9,5,3,2,1,8
1,8,9,6,7,2,3,4,5
