9,7,1,5,2,4,8,6,3
2,8,5,3,7,6,9,4,1
3,4,6,8,9,1,5,7,2
7,3,9,1,6,8,4,2,5
6,5,2,7,4,9,1,3,8
4,1,8,2,3,5,6,9,7
8,9,7,4,1,3,2,5,6
5,2,4,6,8,7,3,1,9
1,6,3,9,5,2,7,8,4
