1,2,9,8,4,3,7,5,6
4,8,6,7,5,9,2,1,3
7,3,5,2,6,1,8,9,4
3,6,8,5,1,2,9,4,7
5,4,7,6,9,8,1,3,2
9,1,2,4,3,7,5,6,8
8,9,1,3,7,4,6,2,5
6,7,3,1,2,5,4,8,9
2,5,4,9,8,6,3,7,1
