0,0,0,0,0,0,0,9,2
5,0,0,0,0,0,0,0,0
4,0,0,0,0,0,0,8,0
0,6,0,3,0,0,0,0,0
0,8,0,5,0,0,0,0,6
0,4,0,7,0,0,3,0,8
0,0,0,0,0,0,0,2,4
0,0,0,0,6,0,9,0,0
9,0,0,0,2,4,6,5,7
