3,7,1,9,2,6,5,4,8
2,4,9,8,5,3,1,7,6
6,8,5,7,4,1,3,2,9
9,1,6,4,8,2,7,5,3
8,5,2,3,7,9,4,6,1
7,3,4,1,6,5,8,9,2
1,6,7,2,3,4,9,8,5
4,2,3,5,9,8,6,1,7
5,9,8,6,1,7,2,3,4
