5,4,8,6,3,1,2,7,9
1,3,7,8,9,2,6,5,4
9,2,6,4,7,5,1,8,3
7,1,3,2,6,8,9,4,5
8,6,4,9,5,7,3,1,2
2,5,9,3,1,4,8,6,7
4,7,2,1,8,3,5,9,6
6,8,5,7,2,9,4,3,1
3,9,1,5,4,6,7,2,8
