1,6,8,7,4,9,3,2,5
9,3,5,1,2,8,7,4,6
7,4,2,6,3,5,8,1,9
2,5,7,8,1,3,9,6,4
6,1,4,2,9,7,5,8,3
3,8,9,4,5,6,1,7,2
5,7,6,9,8,4,2,3,1
8,9,1,3,6,2,4,5,7
4,2,3,5,7,1,6,9,8
