9,7,6,4,3,1,8,2,5
3,1,2,7,8,5,6,4,9
5,4,8,2,9,6,7,1,3
2,9,4,3,6,8,5,7,1
7,5,3,9,1,2,4,6,8
6,8,1,5,7,4,3,9,2
4,3,9,1,5,7,2,8,6
1,6,7,8,2,3,9,5,4
8,2,5,6,4,9,1,3,7
