1,5,7,6,4,8,3,2,9
6,4,3,9,7,2,8,1,5
2,8,9,5,3,1,7,4,6
5,9,4,1,6,3,2,8,7
8,2,1,7,5,9,6,3,4
7,3,6,2,8,4,9,5,1
4,7,5,8,2,6,1,9,3
3,1,8,4,9,7,5,6,2
9,6,2,3,1,5,4,7,8
