0,5,0,0,0,0,8,2,0
0,0,0,0,0,0,0,0,3
0,0,0,6,0,0,0,5,0
0,0,0,0,0,3,1,7,0
0,0,0,5,0,0,0,0,2
0,3,1,7,2,0,0,0,9
0,6,0,0,0,0,2,8,0
0,2,0,0,7,0,0,9,0
8,1,0,0,3,0,0,0,6
