6,7,3,2,9,5,8,4,1
8,1,9,3,4,7,2,6,5
5,2,4,6,8,1,3,9,7
4,3,6,5,2,8,7,1,9
2,9,5,7,1,3,6,8,4
7,8,1,4,6,9,5,3,2
1,5,8,9,7,6,4,2,3
9,4,7,8,3,2,1,5,6
3,6,2,1,5,4,9,7,8
