0,0,4,5,8,0,0,0,0
0,0,1,0,0,9,0,0,0
8,3,6,0,0,0,0,5,0
0,0,0,0,0,8,0,0,0
5,0,8,9,1,0,0,4,3
0,0,0,0,4,0,0,0,0
0,9,5,7,6,1,0,0,0
0,0,0,0,0,0,0,0,0
0,7,0,0,3,0,6,0,0
