3,5,8,7,6,1,9,4,2
4,1,2,9,8,5,3,7,6
7,6,9,3,2,4,8,5,1
6,3,1,5,4,7,2,8,9
9,2,4,1,3,8,7,6,5
5,8,7,2,9,6,4,1,3
2,7,6,4,1,9,5,3,8
1,4,3,8,5,2,6,9,7
8,9,5,6,7,3,1,2,4
