1,0,0,8,0,3,0,5,0
0,0,0,7,0,9,0,0,0
0,0,0,0,6,0,0,0,0
0,0,8,0,1,0,9,0,7
5,0,7,6,0,0,1,3,0
9,1,0,0,0,0,0,6,0
0,0,0,0,7,4,0,0,0
6,0,0,1,0,5,4,8,0
0,0,0,0,0,0,3,0,0
