3,1,5,7,8,9,2,6,4
8,9,4,1,6,2,5,3,7
7,6,2,3,5,4,1,8,9
5,8,9,4,2,1,6,7,3
6,2,3,8,9,7,4,1,5
1,4,7,6,3,5,9,2,8
2,3,1,5,4,8,7,9,6
9,5,8,2,7,6,3,4,1
4,7,6,9,1,3,8,5,2
