0,0,0,5,0,0,0,0,0
0,0,0,0,0,0,0,9,0
0,0,0,4,0,1,0,0,0
0,4,5,0,0,0,9,0,0
7,0,0,0,0,0,3,1,0
0,0,8,2,0,7,0,4,0
0,0,0,0,0,5,0,0,0
0,1,0,9,0,3,4,0,2
0,0,2,0,0,0,1,7,5
