7,9,5,2,4,3,6,8,1
3,2,8,1,6,9,4,5,7
4,6,1,8,7,5,9,3,2
6,1,7,5,3,4,2,9,8
8,4,3,9,2,7,1,6,5
2,5,9,6,8,1,7,4,3
1,8,2,3,9,6,5,7,4
5,7,6,4,1,8,3,2,9
9,3,4,7,5,2,8,1,6
