0,4,8,9,6,0,0,1,0
0,7,0,0,0,0,2,0,0
0,0,0,0,0,0,0,0,0
0,6,0,0,1,9,7,0,0
0,5,0,0,2,0,9,0,0
0,0,0,6,4,0,0,0,0
0,2,0,0,0,0,0,0,0
5,0,0,2,8,0,4,7,1
8,0,0,0,0,6,0,0,5
