8,7,5,3,9,2,4,1,6
2,9,4,1,8,6,5,7,3
6,3,1,7,5,4,8,9,2
1,2,7,4,6,5,9,3,8
5,8,9,2,7,3,6,4,1
4,6,3,8,1,9,2,5,7
3,4,6,5,2,1,7,8,9
7,1,2,9,4,8,3,6,5
9,5,8,6,3,7,1,2,4
