0,8,1,0,3,0,0,5,0
9,0,0,0,0,6,0,0,0
0,6,0,0,9,0,4,0,8
0,0,0,0,0,0,0,3,9
0,5,0,8,0,0,0,0,0
6,0,3,0,0,0,5,0,1
7,0,0,5,0,0,0,0,0
0,0,0,0,0,0,0,4,3
1,0,0,0,0,0,0,6,0
