9,2,1,7,6,4,5,8,3
6,7,8,5,9,3,4,1,2
4,5,3,2,1,8,9,7,6
2,1,4,8,7,5,3,6,9
3,9,6,1,4,2,7,5,8
5,8,7,6,3,9,1,2,4
1,3,5,4,8,6,2,9,7
7,6,9,3,2,1,8,4,5
8,4,2,9,5,7,6,3,1
