8,7,2,3,5,9,1,4,6
5,6,4,1,2,7,3,9,8
9,1,3,6,8,4,2,5,7
4,8,6,7,9,2,5,1,3
3,2,7,5,4,1,6,8,9
1,9,5,8,6,3,4,7,2
7,3,9,2,1,5,8,6,4
6,4,1,9,3,8,7,2,5
2,5,8,4,7,6,9,3,1
