0,0,2,4,0,9,0,8,6
1,0,5,0,0,0,0,0,0
0,0,0,0,8,0,0,0,0
0,0,0,0,0,6,0,2,0
0,0,0,0,1,0,0,0,0
0,6,9,3,0,5,0,0,0
0,3,6,9,0,0,5,0,0
0,0,0,0,0,8,4,0,0
0,5,0,0,6,1,0,0,2
