7,9,0,0,0,0,6,0,0
0,0,0,0,0,0,0,5,0
4,6,0,8,0,5,9,0,0
0,0,0,5,0,4,2,9,8
0,0,3,9,2,7,0,0,5
0,0,0,0,0,0,0,0,3
0,0,2,0,9,6,0,7,0
0,0,0,0,0,8,0,0,0
0,3,0,0,0,0,0,0,0
