9,7,0,0,0,0,0,0,0
0,0,5,3,0,6,9,0,0
0,0,0,8,0,1,0,0,0
0,3,0,0,0,8,0,2,0
6,0,0,0,0,0,0,0,0
0,1,0,2,0,0,0,0,0
0,0,7,0,1,0,0,5,6
0,2,0,0,0,0,0,1,0
0,6,3,0,0,2,7,0,0
