4,3,9,5,7,1,2,6,8
8,2,6,4,3,9,7,5,1
1,7,5,2,6,8,4,3,9
9,1,7,6,4,3,8,2,5
6,5,3,8,1,2,9,4,7
2,8,4,7,9,5,6,1,3
7,6,8,3,5,4,1,9,2
3,9,2,1,8,6,5,7,4
5,4,1,9,2,7,3,8,6
