5,7,6,2,4,1,8,9,3
3,4,1,8,9,7,5,2,6
8,9,2,5,6,3,1,4,7
2,8,3,1,7,6,4,5,9
1,5,7,4,8,9,3,6,2
9,6,4,3,2,5,7,1,8
4,1,9,6,3,8,2,7,5
7,2,8,9,5,4,6,3,1
6,3,5,7,1,2,9,8,4
