9,3,5,6,7,8,2,1,4
7,8,1,5,4,2,9,3,6
2,6,4,3,1,9,8,7,5
4,5,2,8,9,7,3,6,1
6,9,7,2,3,1,5,4,8
3,1,8,4,6,5,7,9,2
8,4,6,9,2,3,1,5,7
1,2,3,7,5,4,6,8,9
5,7,9,1,8,6,4,2,3
