0,4,2,7,8,0,0,0,0
0,0,0,0,0,0,0,0,7
0,0,0,0,0,5,0,0,0
0,5,4,9,0,0,0,7,0
0,0,9,0,0,8,0,4,1
7,0,0,2,1,0,0,9,0
0,0,0,0,0,0,3,0,2
0,9,8,0,0,3,0,0,0
0,0,0,0,0,0,0,1,5
