9,5,6,3,1,7,8,2,4
7,8,2,9,5,4,6,1,3
1,4,3,6,8,2,9,5,7
2,9,5,4,6,3,1,7,8
6,7,8,5,9,1,4,3,2
4,3,1,7,2,8,5,6,9
3,6,7,1,4,9,2,8,5
5,2,4,8,7,6,3,9,1
8,1,9,2,3,5,7,4,6
