1,2,0,0,7,0,9,0,0
0,0,7,0,0,0,0,0,5
0,4,0,9,0,0,0,6,0
0,9,0,0,1,0,0,0,0
6,0,2,0,0,0,5,7,8
0,8,5,0,0,0,0,0,0
8,0,1,0,0,0,0,4,2
2,0,0,0,0,0,8,0,6
0,6,4,0,0,0,0,0,1
