6,0,0,1,0,5,0,0,0
0,0,0,0,2,0,1,0,0
0,3,0,0,7,0,0,8,0
2,9,0,7,0,0,0,0,0
0,0,7,5,0,0,0,0,8
8,0,6,0,0,9,0,0,3
0,0,9,0,0,0,0,0,0
1,2,0,0,0,0,0,0,5
0,7,0,2,6,1,0,0,0
