1,9,3,5,2,7,6,8,4
4,6,5,8,1,3,7,2,9
7,8,2,9,4,6,1,5,3
3,4,8,1,6,9,5,7,2
5,1,9,7,8,2,4,3,6
2,7,6,3,5,4,9,1,8
8,2,7,4,9,5,3,6,1
6,3,4,2,7,1,8,9,5
9,5,1,6,3,8,2,4,7
