9,2,4,5,8,6,7,3,1
7,5,1,3,2,9,4,8,6
8,3,6,1,7,4,9,5,2
3,4,7,2,5,8,1,6,9
5,6,8,9,1,7,2,4,3
2,1,9,6,4,3,8,7,5
4,9,5,7,6,1,3,2,8
6,8,3,4,9,2,5,1,7
1,7,2,8,3,5,6,9,4
