8,1,3,6,5,7,4,9,2
5,9,2,4,1,8,7,6,3
4,7,6,2,3,9,1,8,5
1,6,7,3,8,2,5,4,9
3,8,9,5,4,1,2,7,6
2,4,5,7,9,6,3,1,8
6,5,1,9,7,3,8,2,4
7,2,4,8,6,5,9,3,1
9,3,8,1,2,4,6,5,7
