0,0,0,0,2,0,0,0,3
0,0,0,0,0,0,0,0,0
7,3,9,0,4,0,0,0,0
3,0,0,2,0,0,0,0,9
0,4,0,9,1,0,0,5,2
0,0,0,5,0,0,0,4,0
0,0,4,0,0,3,1,0,8
8,0,0,0,0,0,0,0,4
9,0,2,0,0,7,0,0,5
