2,8,1,5,3,9,7,6,4
4,5,3,7,6,2,8,9,1
9,6,7,4,8,1,2,5,3
6,4,5,3,1,8,9,2,7
7,2,9,6,5,4,3,1,8
1,3,8,2,9,7,5,4,6
8,7,4,1,2,5,6,3,9
5,1,6,9,7,3,4,8,2
3,9,2,8,4,6,1,7,5
