8,1,4,9,2,6,3,7,5
9,3,5,8,7,1,4,2,6
6,2,7,4,3,5,9,1,8
3,8,1,5,9,2,6,4,7
7,4,2,6,1,8,5,9,3
5,6,9,7,4,3,1,8,2
2,5,6,1,8,9,7,3,4
1,7,3,2,6,4,8,5,9
4,9,8,3,5,7,2,6,1
