3,7,2,4,5,9,1,8,6
1,8,5,6,7,3,2,4,9
6,9,4,1,8,2,7,5,3
5,1,7,8,9,6,3,2,4
8,4,3,2,1,7,6,9,5
2,6,9,3,4,5,8,7,1
7,3,6,9,2,4,5,1,8
9,2,1,5,3,8,4,6,7
4,5,8,7,6,1,9,3,2
