9,4,2,7,1,8,3,6,5
5,7,3,6,9,2,4,1,8
6,1,8,5,3,4,2,7,9
4,3,6,2,5,1,9,8,7
8,9,1,4,7,3,5,2,6
7,2,5,8,6,9,1,4,3
3,8,9,1,2,7,6,5,4
1,5,4,9,8,6,7,3,2
2,6,7,3,4,5,8,9,1
