0,1,0,7,0,0,0,0,4
8,0,0,0,6,2,0,3,0
0,0,0,3,5,0,1,8,0
0,0,0,0,0,1,0,0,0
0,0,3,0,0,0,0,0,5
0,4,7,6,3,0,0,2,0
2,0,1,0,0,0,0,0,0
0,5,0,0,0,0,0,4,0
0,7,6,0,0,0,0,5,0
