0,0,9,5,0,1,0,6,0
0,0,0,4,0,9,7,0,0
0,7,0,0,0,0,0,3,0
0,0,0,0,0,0,0,0,0
0,0,0,0,1,2,9,0,0
2,0,4,0,0,0,0,0,3
0,6,0,0,0,4,1,0,2
0,0,0,0,0,6,0,7,4
5,0,0,9,0,0,0,0,0
