1,0,9,0,3,0,0,0,0
0,0,0,0,5,7,0,3,0
0,0,2,1,8,0,0,0,5
0,0,0,8,0,0,0,0,0
0,0,0,0,0,0,0,0,2
4,0,0,0,0,0,3,0,0
2,4,0,0,1,0,5,9,0
0,0,0,3,0,0,0,0,1
7,8,0,0,0,4,2,0,0
