0,0,6,0,0,1,0,0,0
0,0,2,7,0,5,0,0,0
0,0,0,0,0,0,0,1,3
0,0,0,0,0,8,5,0,0
0,0,3,0,0,0,0,6,0
0,0,0,0,0,0,0,9,2
0,0,9,0,0,0,2,8,6
1,0,7,0,0,0,9,0,0
8,0,0,6,0,9,0,3,0
