1,0,7,0,0,9,2,3,0
0,0,5,3,1,0,0,8,7
0,0,8,6,2,0,0,1,0
0,0,9,0,0,0,1,7,0
0,0,0,0,0,0,0,0,0
0,0,0,0,0,0,9,0,0
9,0,0,0,5,0,0,0,0
0,5,3,1,0,0,0,2,0
0,0,1,0,7,6,0,0,0
