1,6,7,5,8,9,2,3,4
2,9,5,3,1,4,6,8,7
3,4,8,6,2,7,5,1,9
6,3,9,8,4,5,1,7,2
7,8,2,9,6,1,4,5,3
5,1,4,7,3,2,9,6,8
9,7,6,2,5,3,8,4,1
4,5,3,1,9,8,7,2,6
8,2,1,4,7,6,3,9,5
