9,0,0,2,0,0,0,0,0
0,0,5,0,0,9,8,0,0
0,2,7,0,5,0,0,0,1
7,0,0,3,0,0,0,0,0
0,0,0,1,2,0,9,0,0
3,0,8,0,4,0,5,0,0
0,0,9,4,0,0,0,0,0
0,3,4,7,8,1,0,0,0
0,0,0,0,0,2,0,0,0
