6,1,2,3,7,4,8,5,9
7,8,3,9,5,6,1,2,4
5,4,9,1,2,8,6,3,7
4,6,7,8,1,2,5,9,3
8,9,5,6,3,7,4,1,2
2,3,1,5,4,9,7,8,6
9,2,8,4,6,1,3,7,5
1,5,4,7,9,3,2,6,8
3,7,6,2,8,5,9,4,1
