5,3,7,8,2,4,9,6,1
6,9,1,5,7,3,2,4,8
4,8,2,6,9,1,5,7,3
7,6,3,2,8,5,4,1,9
2,4,8,3,1,9,6,5,7
1,5,9,4,6,7,3,8,2
9,7,6,1,4,2,8,3,5
8,2,5,7,3,6,1,9,4
3,1,4,9,5,8,7,2,6
