4,8,6,7,2,1,5,9,3
1,2,5,3,6,9,4,8,7
7,3,9,8,4,5,2,1,6
3,5,1,2,7,4,8,6,9
6,4,7,9,1,8,3,5,2
2,9,8,5,3,6,7,4,1
5,7,4,6,9,3,1,2,8
8,6,3,1,5,2,9,7,4
9,1,2,4,8,7,6,3,5
