1,9,5,3,4,2,6,7,8
2,4,7,6,5,8,9,3,1
6,8,3,7,1,9,2,5,4
5,6,8,2,9,4,3,1,7
7,2,9,8,3,1,4,6,5
3,1,4,5,6,7,8,9,2
9,7,2,1,8,3,5,4,6
4,5,1,9,2,6,7,8,3
8,3,6,4,7,5,1,2,9
