1,2,3,7,4,9,8,5,6
8,6,4,3,5,2,9,7,1
7,5,9,6,8,1,2,3,4
9,3,8,4,2,6,7,1,5
2,7,5,9,1,3,4,6,8
6,4,1,5,7,8,3,9,2
3,9,2,8,6,5,1,4,7
5,1,7,2,3,4,6,8,9
4,8,6,1,9,7,5,2,3
