0,0,4,0,0,6,3,7,5
9,3,0,0,0,0,0,0,0
0,2,7,0,0,0,0,0,0
0,0,1,5,0,0,6,0,0
7,4,0,0,1,0,0,9,0
0,0,0,7,0,0,0,0,0
2,0,6,0,0,0,7,0,4
0,0,3,0,0,0,0,0,9
0,9,0,0,0,0,0,6,1
