0,0,0,0,0,5,8,0,0
0,1,3,0,0,0,0,6,0
5,8,0,0,0,4,0,3,0
0,0,0,0,0,0,0,0,0
0,0,0,8,5,1,4,7,0
0,0,0,0,0,0,0,0,9
4,0,0,7,0,8,0,0,0
0,0,6,3,0,0,0,0,0
7,3,0,0,0,9,0,1,6
