2,5,8,6,3,7,9,4,1
6,9,1,8,2,4,3,5,7
4,7,3,5,9,1,8,2,6
5,3,7,2,8,6,4,1,9
8,6,9,4,1,5,7,3,2
1,2,4,9,7,3,5,6,8
9,8,5,1,4,2,6,7,3
3,1,6,7,5,8,2,9,4
7,4,2,3,6,9,1,8,5
