6,8,2,1,9,5,3,4,7
7,4,5,3,2,8,1,9,6
9,3,1,6,7,4,5,8,2
2,9,3,7,8,6,4,5,1
4,1,7,5,3,2,9,6,8
8,5,6,4,1,9,7,2,3
3,6,9,8,5,7,2,1,4
1,2,8,9,4,3,6,7,5
5,7,4,2,6,1,8,3,9
