0,0,0,0,4,0,8,0,3
0,0,0,0,0,0,0,2,0
0,0,0,0,0,0,0,0,0
2,0,0,1,7,0,0,5,0
1,0,0,0,8,9,3,0,0
9,0,4,3,0,0,0,0,0
0,0,9,0,3,0,0,0,5
7,2,0,9,0,0,0,0,1
0,3,5,0,0,0,0,8,4
