0,5,0,7,0,0,0,0,0
0,0,0,0,0,0,0,0,6
7,6,9,0,0,0,8,0,1
0,0,0,0,4,0,0,0,9
9,2,4,0,0,0,0,0,0
0,0,0,0,0,6,0,1,0
2,0,0,4,0,9,5,0,8
1,0,0,0,0,0,6,0,7
8,0,5,0,0,0,0,0,4
