0,0,3,7,0,0,0,0,0
8,6,0,3,0,2,9,0,0
0,0,0,6,0,0,2,0,0
0,3,8,4,0,0,0,1,0
2,0,0,9,0,0,4,6,0
0,0,1,0,0,8,0,0,2
0,0,0,0,0,0,0,4,7
0,0,7,0,0,0,0,0,9
4,0,0,0,0,0,0,2,0
