6,9,4,1,3,5,8,2,7
2,1,3,9,8,7,5,6,4
5,8,7,6,2,4,9,3,1
8,7,2,4,9,6,1,5,3
3,6,9,8,5,1,4,7,2
1,4,5,2,7,3,6,8,9
4,2,1,7,6,8,3,9,5
9,5,6,3,1,2,7,4,8
7,3,8,5,4,9,2,1,6
