8,6,7,5,2,9,3,1,4
3,5,9,1,6,4,2,8,7
4,1,2,3,8,7,9,5,6
9,8,3,7,1,5,6,4,2
2,7,6,9,4,8,5,3,1
1,4,5,6,3,2,7,9,8
6,9,8,4,7,3,1,2,5
7,3,4,2,5,1,8,6,9
5,2,1,8,9,6,4,7,3
