6,5,3,7,1,8,4,9,2
4,1,2,3,9,5,7,6,8
7,9,8,4,6,2,5,3,1
2,4,6,8,7,9,3,1,5
1,3,9,5,2,4,8,7,6
8,7,5,1,3,6,9,2,4
3,6,4,9,5,1,2,8,7
9,8,1,2,4,7,6,5,3
5,2,7,6,8,3,1,4,9
