1,5,9,4,3,6,7,2,8
8,6,4,2,5,7,1,3,9
3,7,2,1,8,9,6,4,5
5,2,7,8,6,3,9,1,4
9,3,6,7,4,1,8,5,2
4,1,8,9,2,5,3,7,6
2,4,3,6,1,8,5,9,7
6,9,5,3,7,2,4,8,1
7,8,1,5,9,4,2,6,3
