4,8,1,7,3,2,9,5,6
9,2,5,4,8,6,3,1,7
3,6,7,1,9,5,4,2,8
8,1,4,6,5,7,2,3,9
2,5,9,8,1,3,6,7,4
6,7,3,9,2,4,5,8,1
7,3,6,5,4,8,1,9,2
5,9,8,2,6,1,7,4,3
1,4,2,3,7,9,8,6,5
