1,2,6,4,7,5,9,8,3
9,3,7,2,8,6,4,1,5
5,4,8,9,3,1,2,6,7
7,9,3,5,1,8,6,2,4
6,1,2,3,9,4,5,7,8
4,8,5,6,2,7,1,3,9
8,5,1,7,6,9,3,4,2
2,7,9,1,4,3,8,5,6
3,6,4,8,5,2,7,9,1
