1,6,3,2,9,8,4,5,7
5,4,2,1,3,7,6,8,9
7,8,9,5,4,6,2,1,3
8,9,7,4,6,1,3,2,5
2,1,4,3,8,5,7,9,6
3,5,6,9,7,2,1,4,8
4,3,5,7,1,9,8,6,2
6,2,1,8,5,3,9,7,4
9,7,8,6,2,4,5,3,1
