2,4,8,9,6,7,5,1,3
6,7,5,1,3,4,2,8,9
9,3,1,8,5,2,6,4,7
4,6,2,3,1,9,7,5,8
1,5,3,7,2,8,9,6,4
7,8,9,6,4,5,1,3,2
3,2,4,5,7,1,8,9,6
5,9,6,2,8,3,4,7,1
8,1,7,4,9,6,3,2,5
