6,0,3,2,9,0,0,0,1
8,0,0,3,4,0,2,0,0
5,0,4,6,0,0,3,0,0
0,0,0,5,0,8,0,1,9
0,0,5,0,1,0,0,8,4
0,0,0,0,0,0,0,0,0
0,0,0,9,0,0,0,2,0
0,0,0,0,3,0,0,0,6
0,0,0,1,5,0,0,0,0
