9,0,8,0,0,5,0,0,0
1,0,4,0,2,6,3,0,8
0,6,0,0,0,0,0,4,0
0,0,9,2,0,0,0,0,6
0,0,1,0,6,0,0,0,0
4,0,0,0,1,0,9,3,0
0,0,0,5,8,2,6,1,0
0,0,0,1,0,3,0,0,0
0,0,0,0,0,0,0,0,0
