3,9,5,2,8,4,6,7,1
1,2,7,6,5,3,9,4,8
8,6,4,1,9,7,3,2,5
6,8,3,5,2,1,4,9,7
7,4,9,8,3,6,1,5,2
2,5,1,4,7,9,8,6,3
4,7,8,9,1,5,2,3,6
5,1,6,3,4,2,7,8,9
9,3,2,7,6,8,5,1,4
