5,4,7,8,2,6,9,3,1
1,9,2,5,4,3,6,7,8
8,3,6,7,1,9,4,5,2
7,5,9,4,6,8,2,1,3
4,1,8,2,3,7,5,6,9
6,2,3,9,5,1,8,4,7
2,7,5,3,9,4,1,8,6
9,8,1,6,7,5,3,2,4
3,6,4,1,8,2,7,9,5
