3,7,1,5,9,4,6,8,2
8,2,5,1,6,7,9,4,3
4,6,9,3,8,2,1,5,7
7,8,6,4,1,3,5,2,9
9,1,3,2,5,8,4,7,6
2,5,4,9,7,6,8,3,1
6,9,8,7,2,5,3,1,4
1,4,2,8,3,9,7,6,5
5,3,7,6,4,1,2,9,8
