7,6,2,5,3,4,1,8,9
1,9,5,8,7,2,4,3,6
8,4,3,1,6,9,2,5,7
2,5,8,4,9,7,6,1,3
6,7,1,2,5,3,9,4,8
9,3,4,6,1,8,7,2,5
4,2,7,3,8,6,5,9,1
3,1,9,7,4,5,8,6,2
5,8,6,9,2,1,3,7,4
