0,0,0,0,2,0,0,0,6
9,0,0,0,0,0,0,3,0
0,0,0,0,0,9,0,0,4
0,4,0,0,3,0,0,9,0
0,0,6,0,0,1,0,4,0
0,3,0,6,5,0,0,0,0
0,0,2,0,6,0,3,0,0
0,1,5,0,9,0,0,0,0
0,8,4,1,0,0,0,0,0
