4,0,2,0,0,0,0,0,0
5,0,0,9,0,0,0,0,0
0,1,0,4,5,0,8,0,0
0,2,5,0,6,0,0,0,0
1,8,0,0,0,9,0,0,0
0,9,4,0,1,0,0,0,0
0,0,6,0,0,1,2,5,0
0,0,9,0,8,0,4,1,0
0,0,0,0,0,2,0,3,8
