3,6,8,2,9,5,1,4,7
2,9,5,4,1,7,3,8,6
1,4,7,3,8,6,2,5,9
8,2,3,5,7,1,6,9,4
9,1,4,6,3,8,5,7,2
7,5,6,9,4,2,8,1,3
5,7,2,8,6,9,4,3,1
4,8,9,1,2,3,7,6,5
6,3,1,7,5,4,9,2,8
