1,8,0,7,2,0,5,0,0
0,9,3,8,1,0,0,2,0
5,0,6,0,0,0,0,0,0
8,0,0,0,0,0,0,0,0
0,0,0,0,0,0,8,0,0
2,1,7,0,0,0,0,0,6
9,3,0,1,0,0,0,0,8
0,0,0,0,7,0,0,0,0
0,0,0,3,5,0,0,1,0
