2,7,4,6,1,3,8,9,5
9,5,1,2,8,4,6,7,3
3,8,6,5,7,9,2,4,1
8,3,7,1,6,5,4,2,9
5,6,2,4,9,8,3,1,7
1,4,9,7,3,2,5,8,6
7,1,5,8,2,6,9,3,4
6,9,8,3,4,7,1,5,2
4,2,3,9,5,1,7,6,8
