0,0,0,4,0,8,1,0,0
0,4,0,0,7,1,8,6,0
8,0,0,0,0,9,0,7,5
0,0,0,0,0,7,0,5,0
7,5,0,0,0,0,0,0,0
0,2,0,6,0,0,0,0,0
4,0,2,9,0,5,0,0,0
6,7,0,8,0,0,0,0,0
0,1,5,0,2,0,0,0,0
