7,8,2,9,4,6,3,1,5
1,9,3,8,2,5,6,7,4
5,4,6,7,1,3,2,9,8
9,5,4,2,6,1,7,8,3
3,6,1,4,7,8,5,2,9
8,2,7,5,3,9,4,6,1
6,7,9,3,8,4,1,5,2
4,1,8,6,5,2,9,3,7
2,3,5,1,9,7,8,4,6
