0,0,9,0,0,0,5,0,6
0,6,0,0,0,0,4,7,0
0,1,0,0,0,0,3,0,0
5,0,0,9,0,3,0,0,0
0,9,6,0,7,1,2,0,3
0,0,0,0,4,0,9,0,5
0,5,3,4,6,0,1,0,0
0,0,7,0,0,0,0,0,0
0,0,0,0,0,9,0,0,0
