0,0,0,0,0,0,8,0,0
0,0,0,0,0,0,0,0,0
2,0,0,0,0,8,0,9,0
8,0,0,9,0,5,7,0,2
1,0,0,0,8,0,0,5,0
0,5,0,0,2,1,9,3,0
5,1,0,0,0,9,0,2,6
6,0,8,0,1,2,0,0,0
0,0,7,5,0,0,1,0,0
