0,0,0,0,0,0,0,7,6
7,0,8,0,0,0,3,5,0
3,6,9,0,0,0,2,0,0
8,0,0,7,2,1,9,0,0
0,0,6,9,0,0,0,0,0
0,0,1,3,0,0,0,0,7
0,2,0,0,0,5,0,1,0
0,0,0,2,0,0,8,0,0
0,0,0,0,0,0,0,9,0
