8,6,4,5,1,7,3,2,9
5,3,7,9,2,8,4,6,1
9,2,1,6,4,3,5,7,8
6,4,5,8,7,9,2,1,3
2,7,9,1,3,6,8,5,4
3,1,8,2,5,4,6,9,7
4,5,2,7,8,1,9,3,6
7,8,6,3,9,5,1,4,2
1,9,3,4,6,2,7,8,5
