3,7,5,2,9,6,8,4,1
4,8,9,1,3,7,2,6,5
2,6,1,4,5,8,3,9,7
8,3,6,9,4,5,7,1,2
1,9,2,7,8,3,6,5,4
7,5,4,6,2,1,9,3,8
5,1,3,8,7,9,4,2,6
6,4,8,3,1,2,5,7,9
9,2,7,5,6,4,1,8,3
