9,3,4,8,7,6,5,2,1
1,5,8,3,2,4,7,9,6
7,6,2,5,1,9,4,8,3
8,1,6,4,9,7,3,5,2
5,9,3,6,8,2,1,7,4
2,4,7,1,3,5,9,6,8
6,2,5,9,4,3,8,1,7
3,7,1,2,5,8,6,4,9
4,8,9,7,6,1,2,3,5
