0,9,1,8,0,0,4,0,2
8,0,5,0,1,0,3,0,0
0,0,0,4,0,5,0,0,0
0,0,0,0,0,9,0,0,0
0,0,0,0,0,0,0,3,0
2,5,8,0,0,4,0,0,0
0,0,0,0,9,1,0,0,0
0,0,9,0,0,0,0,0,7
7,0,4,0,0,0,8,0,0
