5,8,1,6,4,3,9,7,2
3,2,9,7,1,5,4,6,8
4,6,7,9,2,8,3,1,5
1,5,4,8,3,2,7,9,6
2,7,6,4,5,9,1,8,3
9,3,8,1,6,7,2,5,4
6,4,5,2,9,1,8,3,7
8,1,2,3,7,6,5,4,9
7,9,3,5,8,4,6,2,1
