5,0,0,0,0,0,0,0,0
0,0,0,7,1,0,0,0,8
0,6,7,9,0,0,3,1,0
0,0,0,0,3,0,7,0,0
0,7,0,0,0,0,1,0,0
0,3,0,1,6,0,0,5,0
0,0,5,2,0,0,8,3,0
0,0,0,0,0,6,5,0,9
0,0,0,0,8,0,0,0,0
