6,8,3,1,2,7,4,5,9
7,5,9,6,8,4,3,2,1
2,1,4,9,5,3,6,8,7
1,3,5,8,4,9,7,6,2
8,9,6,2,7,5,1,3,4
4,7,2,3,1,6,8,9,5
3,4,7,5,9,8,2,1,6
5,2,8,7,6,1,9,4,3
9,6,1,4,3,2,5,7,8
