5,6,4,9,3,2,8,1,7
2,1,9,8,7,4,3,6,5
3,8,7,1,6,5,4,2,9
4,7,5,6,9,8,2,3,1
8,9,6,3,2,1,5,7,4
1,2,3,4,5,7,6,9,8
6,5,1,7,8,3,9,4,2
7,3,2,5,4,9,1,8,6
9,4,8,2,1,6,7,5,3
