2,5,1,9,6,4,3,7,8
4,8,3,5,7,2,1,6,9
6,7,9,1,3,8,2,5,4
8,9,6,2,4,7,5,3,1
7,1,4,8,5,3,6,9,2
3,2,5,6,1,9,8,4,7
9,3,2,7,8,5,4,1,6
5,6,8,4,9,1,7,2,3
1,4,7,3,2,6,9,8,5
