6,9,1,8,7,3,4,5,2
8,4,5,9,1,2,3,7,6
3,2,7,4,6,5,9,1,8
4,7,3,6,2,9,1,8,5
9,1,6,5,8,7,2,3,4
2,5,8,1,3,4,7,6,9
5,8,2,7,9,1,6,4,3
1,6,9,3,4,8,5,2,7
7,3,4,2,5,6,8,9,1
