9,2,5,8,4,6,7,1,3
3,7,4,1,2,5,9,6,8
6,8,1,9,3,7,5,2,4
5,4,8,2,1,9,3,7,6
2,9,6,5,7,3,8,4,1
1,3,7,4,6,8,2,5,9
8,6,2,7,9,1,4,3,5
4,5,3,6,8,2,1,9,7
7,1,9,3,5,4,6,8,2
