0,0,0,7,0,0,0,0,0
9,6,0,0,0,8,0,0,0
0,1,8,0,0,6,0,0,0
8,0,9,2,0,0,0,0,0
0,0,2,5,8,1,0,6,0
0,0,0,0,0,0,5,0,2
0,0,0,0,0,0,0,0,0
6,8,0,1,3,7,0,9,0
0,0,3,8,2,0,0,0,0
