0,9,0,0,0,0,0,7,1
0,0,0,6,5,3,0,0,0
0,0,0,0,0,0,0,0,0
0,8,0,0,0,0,0,9,0
0,0,0,8,3,6,0,5,0
0,0,1,0,7,0,0,0,0
0,7,8,0,1,0,0,3,0
5,0,0,0,0,0,0,0,0
9,3,2,0,0,8,5,0,0
