7,5,6,3,8,2,1,4,9
8,3,4,5,1,9,7,2,6
2,1,9,4,7,6,3,8,5
4,9,8,2,6,1,5,3,7
1,2,7,9,5,3,4,6,8
3,6,5,8,4,7,9,1,2
5,7,2,6,3,4,8,9,1
9,4,1,7,2,8,6,5,3
6,8,3,1,9,5,2,7,4
