4,6,3,8,1,9,2,5,7
2,1,7,6,5,4,8,3,9
5,8,9,7,3,2,1,6,4
8,4,5,9,6,1,7,2,3
9,7,6,2,8,3,5,4,1
1,3,2,4,7,5,9,8,6
3,9,4,5,2,7,6,1,8
6,5,1,3,9,8,4,7,2
7,2,8,1,4,6,3,9,5
