2,6,9,3,4,5,1,7,8
5,1,7,8,6,9,4,2,3
4,8,3,2,7,1,5,9,6
1,2,5,7,3,4,6,8,9
8,3,4,6,9,2,7,1,5
7,9,6,1,5,8,2,3,4
6,7,1,4,8,3,9,5,2
3,5,2,9,1,6,8,4,7
9,4,8,5,2,7,3,6,1
