0,0,0,0,0,0,8,0,4
0,0,1,0,0,0,0,0,0
8,5,6,0,0,0,0,1,0
4,0,0,8,7,0,1,0,6
0,0,0,0,2,1,0,0,9
0,8,0,0,0,0,0,0,0
9,0,0,0,0,0,7,0,8
0,2,0,0,0,0,9,0,1
0,0,0,4,0,5,0,0,0
