4,1,3,8,7,9,6,5,2
6,8,2,1,5,3,4,7,9
5,9,7,4,2,6,8,1,3
2,4,1,3,8,7,5,9,6
9,3,6,5,4,1,2,8,7
7,5,8,9,6,2,3,4,1
3,7,4,2,9,5,1,6,8
8,2,9,6,1,4,7,3,5
1,6,5,7,3,8,9,2,4
