0,5,0,0,8,2,1,4,0
0,0,0,0,1,9,0,0,0
2,0,0,4,7,0,3,0,0
4,9,0,0,0,0,0,0,0
0,0,7,0,0,0,0,0,8
3,0,0,0,0,0,0,0,2
5,0,2,0,0,0,0,0,0
9,4,0,0,0,8,0,5,0
0,0,3,0,0,0,2,7,4
