0,0,2,9,4,6,0,1,5
0,9,0,8,0,0,6,0,0
0,0,0,7,0,0,0,0,0
9,5,4,0,6,0,0,8,0
0,0,1,4,7,0,0,0,0
0,2,0,0,0,0,0,0,1
6,7,9,0,0,0,0,0,0
0,1,8,0,5,2,0,0,0
0,0,0,0,0,0,0,0,0
