7,9,8,6,2,3,4,1,5
3,6,5,1,7,4,2,9,8
4,1,2,5,9,8,6,7,3
2,5,7,9,4,6,8,3,1
8,3,1,7,5,2,9,6,4
9,4,6,8,3,1,7,5,2
1,8,3,2,6,9,5,4,7
6,7,4,3,8,5,1,2,9
5,2,9,4,1,7,3,8,6
