4,3,7,6,8,1,9,5,2
1,9,6,5,7,2,4,3,8
5,8,2,3,9,4,1,6,7
8,5,4,1,6,9,2,7,3
6,1,9,2,3,7,5,8,4
7,2,3,8,4,5,6,1,9
9,6,5,7,2,8,3,4,1
2,7,1,4,5,3,8,9,6
3,4,8,9,1,6,7,2,5
