1,6,3,5,8,7,2,9,4
8,5,2,1,9,4,7,6,3
9,7,4,6,2,3,1,5,8
7,8,9,4,1,6,5,3,2
2,4,5,7,3,9,8,1,6
6,3,1,8,5,2,9,4,7
3,9,6,2,7,5,4,8,1
5,2,8,3,4,1,6,7,9
4,1,7,9,6,8,3,2,5
