8,0,0,5,0,0,3,2,0
0,0,7,0,0,0,0,0,0
0,2,1,0,0,0,0,0,0
6,0,5,8,0,0,0,0,0
0,7,0,0,3,0,0,0,0
3,1,8,0,0,0,0,0,0
0,5,2,0,0,0,9,3,0
0,0,0,0,9,0,1,0,0
1,0,0,0,6,2,7,8,0
