5,3,4,7,9,2,6,1,8
9,6,7,4,1,8,3,2,5
2,1,8,3,5,6,9,4,7
8,5,9,2,6,4,7,3,1
3,7,2,5,8,1,4,6,9
1,4,6,9,7,3,5,8,2
7,2,1,6,4,9,8,5,3
6,8,5,1,3,7,2,9,4
4,9,3,8,2,5,1,7,6
