3,8,2,4,5,7,6,1,9
5,7,9,6,1,8,2,4,3
4,1,6,9,2,3,7,5,8
8,2,4,5,6,9,1,3,7
1,6,3,8,7,2,4,9,5
7,9,5,1,3,4,8,2,6
6,4,1,3,8,5,9,7,2
9,5,7,2,4,6,3,8,1
2,3,8,7,9,1,5,6,4
