1,4,6,3,5,7,9,8,2
5,2,9,8,4,1,3,6,7
7,3,8,2,6,9,4,5,1
4,5,1,6,3,2,7,9,8
9,6,3,4,7,8,1,2,5
2,8,7,1,9,5,6,3,4
6,7,4,5,8,3,2,1,9
8,9,2,7,1,6,5,4,3
3,1,5,9,2,4,8,7,6
