5,9,7,4,6,8,1,2,3
2,4,3,5,7,1,8,6,9
8,6,1,2,3,9,4,7,5
9,3,6,1,8,7,2,5,4
7,5,4,3,9,2,6,8,1
1,2,8,6,5,4,3,9,7
4,8,2,9,1,5,7,3,6
6,7,9,8,4,3,5,1,2
3,1,5,7,2,6,9,4,8
