5,0,9,0,6,0,0,0,3
0,0,0,3,8,0,0,0,0
0,7,0,0,4,9,0,0,0
0,0,0,0,7,0,0,0,0
0,4,7,5,0,8,0,0,0
0,6,0,9,3,0,0,0,0
0,0,4,0,0,3,0,6,9
0,3,6,1,0,0,0,7,0
0,0,5,0,0,0,0,0,0
