2,7,9,1,5,6,8,3,4
3,4,1,2,8,7,6,9,5
8,5,6,9,3,4,2,1,7
4,9,5,8,7,3,1,2,6
6,3,7,5,2,1,4,8,9
1,8,2,6,4,9,5,7,3
9,6,4,3,1,2,7,5,8
5,2,3,7,6,8,9,4,1
7,1,8,4,9,5,3,6,2
