4,3,0,0,0,0,0,0,0
0,0,0,0,0,0,0,0,8
0,0,2,3,0,0,0,0,0
8,5,0,0,0,9,0,0,0
0,0,9,0,3,0,0,0,0
0,0,0,8,0,5,6,0,9
9,0,0,0,2,8,3,0,1
2,0,1,0,0,0,8,0,6
0,4,0,0,0,6,0,2,0
