5,3,7,1,6,4,2,8,9
2,9,4,8,7,3,6,1,5
1,8,6,9,5,2,7,4,3
9,6,2,3,4,5,8,7,1
8,7,3,6,2,1,9,5,4
4,5,1,7,8,9,3,2,6
7,2,5,4,9,6,1,3,8
3,4,9,2,1,8,5,6,7
6,1,8,5,3,7,4,9,2
