0,0,6,3,0,0,0,0,0
0,0,0,8,0,0,0,0,7
7,0,0,0,0,0,0,0,0
4,5,0,0,0,0,7,9,8
0,0,0,0,7,0,0,0,5
0,0,0,0,0,0,0,3,4
6,0,4,0,0,0,0,1,9
8,9,0,0,1,0,5,0,3
3,0,0,9,0,0,8,0,0
