0,0,0,3,0,0,0,0,8
5,1,0,0,0,0,0,0,0
0,0,3,0,0,1,0,0,0
0,0,5,7,0,4,0,8,9
0,0,0,0,0,2,0,1,0
7,9,0,1,0,0,0,3,4
0,0,0,4,0,0,0,5,0
3,0,2,9,0,0,0,0,0
9,0,8,0,0,0,0,0,0
