7,2,9,8,3,5,6,1,4
5,4,1,6,2,9,3,7,8
3,8,6,4,1,7,5,9,2
2,3,7,5,9,1,8,4,6
9,6,5,3,8,4,1,2,7
4,1,8,2,7,6,9,5,3
1,9,3,7,6,2,4,8,5
6,7,4,1,5,8,2,3,9
8,5,2,9,4,3,7,6,1
