0,0,8,6,0,3,0,0,0
3,6,0,0,0,0,0,9,0
0,1,0,0,0,8,0,0,0
0,0,7,9,4,0,0,0,1
0,3,0,0,0,0,0,0,4
0,0,0,0,3,1,7,0,0
0,0,0,2,0,0,0,0,7
0,0,4,0,0,0,1,0,0
0,2,9,4,0,0,3,0,0
