5,8,9,7,6,1,4,2,3
4,2,1,3,8,5,7,9,6
6,7,3,2,4,9,1,5,8
3,5,2,4,7,6,9,8,1
9,4,7,5,1,8,6,3,2
1,6,8,9,3,2,5,4,7
7,1,4,8,5,3,2,6,9
2,3,6,1,9,4,8,7,5
8,9,5,6,2,7,3,1,4
