9,2,1,8,4,7,6,3,5
7,8,6,3,5,1,9,2,4
5,3,4,2,9,6,8,1,7
2,9,5,7,8,4,1,6,3
3,1,8,9,6,5,7,4,2
6,4,7,1,2,3,5,9,8
4,5,3,6,1,8,2,7,9
1,7,9,5,3,2,4,8,6
8,6,2,4,7,9,3,5,1
