2,7,9,8,3,4,5,1,6
3,6,8,1,9,5,4,7,2
4,1,5,6,2,7,3,9,8
5,2,4,9,8,3,7,6,1
8,9,6,5,7,1,2,4,3
7,3,1,2,4,6,9,8,5
9,5,3,4,6,8,1,2,7
6,4,7,3,1,2,8,5,9
1,8,2,7,5,9,6,3,4
