3,8,9,5,7,1,4,6,2
2,7,1,6,4,9,3,8,5
6,4,5,3,8,2,7,1,9
1,2,8,9,3,4,5,7,6
4,5,7,1,2,6,9,3,8
9,6,3,7,5,8,2,4,1
5,1,2,4,6,3,8,9,7
8,9,4,2,1,7,6,5,3
7,3,6,8,9,5,1,2,4
