2,9,5,7,4,1,8,6,3
7,4,8,9,6,3,5,1,2
1,6,3,5,2,8,4,9,7
8,7,6,2,9,5,3,4,1
3,1,4,8,7,6,9,2,5
5,2,9,1,3,4,6,7,8
9,5,1,6,8,7,2,3,4
6,3,7,4,5,2,1,8,9
4,8,2,3,1,9,7,5,6
