1,9,2,8,4,3,6,7,5
5,3,7,9,1,6,8,4,2
4,6,8,7,2,5,9,3,1
8,7,6,4,9,2,1,5,3
2,1,9,3,5,8,4,6,7
3,5,4,6,7,1,2,8,9
6,2,5,1,8,7,3,9,4
7,4,3,2,6,9,5,1,8
9,8,1,5,3,4,7,2,6
