8,2,1,4,3,6,5,7,9
5,7,3,8,1,9,6,4,2
6,4,9,5,2,7,8,1,3
4,6,8,7,9,5,3,2,1
2,1,7,6,8,3,4,9,5
9,3,5,1,4,2,7,8,6
3,8,6,2,7,1,9,5,4
1,5,4,9,6,8,2,3,7
7,9,2,3,5,4,1,6,8
