4,6,2,1,7,8,3,9,5
5,7,8,9,2,3,6,4,1
9,1,3,4,5,6,8,7,2
3,2,5,7,6,4,1,8,9
1,8,7,2,3,9,5,6,4
6,9,4,8,1,5,7,2,3
8,4,6,3,9,1,2,5,7
2,3,9,5,8,7,4,1,6
7,5,1,6,4,2,9,3,8
