4,5,1,3,2,7,9,8,6
9,2,7,8,4,6,1,3,5
8,6,3,5,1,9,7,2,4
5,4,8,7,3,2,6,9,1
2,7,6,9,8,1,5,4,3
1,3,9,6,5,4,8,7,2
7,9,2,4,6,5,3,1,8
3,1,5,2,9,8,4,6,7
6,8,4,1,7,3,2,5,9
