2,9,6,5,4,8,1,7,3
1,4,3,7,2,9,6,8,5
8,5,7,1,3,6,2,4,9
3,1,8,4,6,5,7,9,2
5,2,4,3,9,7,8,1,6
6,7,9,2,8,1,3,5,4
9,8,5,6,7,3,4,2,1
4,3,1,8,5,2,9,6,7
7,6,2,9,1,4,5,3,8
