0,0,4,9,0,2,8,0,0
0,0,9,8,0,0,3,6,0
3,0,7,0,6,5,0,0,0
4,0,0,0,0,8,0,0,0
0,9,0,0,0,0,0,0,0
0,2,0,0,0,0,0,9,0
6,5,0,7,8,0,0,0,2
0,0,0,5,0,9,0,0,0
0,0,0,0,0,6,7,0,3
