1,4,7,2,8,3,5,6,9
2,3,9,4,5,6,1,7,8
5,8,6,9,7,1,3,2,4
8,5,3,1,4,7,6,9,2
6,1,2,8,3,9,4,5,7
7,9,4,5,6,2,8,1,3
4,6,8,7,9,5,2,3,1
9,2,5,3,1,4,7,8,6
3,7,1,6,2,8,9,4,5
