2,9,8,7,4,5,1,3,6
3,5,6,1,8,2,9,4,7
4,7,1,3,6,9,2,5,8
9,4,5,8,2,6,3,7,1
8,1,7,5,3,4,6,9,2
6,3,2,9,7,1,5,8,4
1,2,9,4,5,7,8,6,3
7,6,3,2,9,8,4,1,5
5,8,4,6,1,3,7,2,9
