1,3,7,6,8,4,9,2,5
2,9,8,1,3,5,4,7,6
4,6,5,2,7,9,8,3,1
9,1,3,8,5,7,6,4,2
5,8,2,4,6,3,7,1,9
6,7,4,9,1,2,3,5,8
3,5,1,7,9,6,2,8,4
8,4,6,3,2,1,5,9,7
7,2,9,5,4,8,1,6,3
