0,0,0,0,6,0,0,0,0
0,0,0,8,7,0,6,0,0
0,0,0,0,0,0,0,4,3
0,0,0,0,0,0,8,0,0
0,7,3,0,2,1,0,0,4
0,0,1,7,0,9,0,0,0
7,2,0,0,9,0,0,0,0
0,4,0,0,1,0,0,0,7
6,0,0,0,0,0,0,0,2
