0,0,8,0,9,0,1,4,7
0,0,5,4,1,0,3,8,0
0,0,0,0,8,0,0,0,0
0,0,0,0,0,0,0,0,0
9,0,4,0,3,8,5,0,0
7,5,6,9,0,0,0,0,0
0,0,0,0,0,0,0,3,0
0,0,0,0,0,0,7,6,0
0,3,1,0,5,0,9,0,0
