0,0,0,0,0,0,3,0,0
4,0,0,5,0,2,0,6,0
6,7,0,1,0,0,0,5,4
8,0,0,2,4,7,5,3,0
0,0,0,8,0,3,0,0,0
0,0,0,0,1,0,0,0,0
0,0,0,7,8,5,4,0,6
0,0,0,0,0,0,0,0,0
1,0,0,0,0,6,0,8,0
