1,8,4,7,2,6,5,9,3
7,9,3,8,1,5,6,2,4
5,2,6,4,3,9,1,8,7
8,4,5,6,9,7,2,3,1
3,6,9,2,4,1,8,7,5
2,1,7,5,8,3,9,4,6
9,3,2,1,6,4,7,5,8
4,5,1,9,7,8,3,6,2
6,7,8,3,5,2,4,1,9
