4,5,8,9,2,1,7,6,3
6,7,3,8,4,5,9,2,1
9,1,2,7,6,3,5,4,8
8,6,1,3,5,2,4,7,9
7,2,9,6,8,4,1,3,5
3,4,5,1,7,9,6,8,2
1,3,6,4,9,8,2,5,7
2,9,4,5,3,7,8,1,6
5,8,7,2,1,6,3,9,4
