7,3,8,1,5,4,6,9,2
9,2,5,6,7,8,3,1,4
6,1,4,2,3,9,5,8,7
3,4,7,9,2,5,1,6,8
2,5,1,8,4,6,7,3,9
8,6,9,3,1,7,4,2,5
4,8,6,7,9,3,2,5,1
5,9,2,4,6,1,8,7,3
1,7,3,5,8,2,9,4,6
