0,0,0,0,0,0,5,6,9
0,0,0,4,0,0,0,0,0
0,0,0,9,0,0,0,2,4
8,5,0,0,0,0,0,0,2
6,0,0,8,0,0,0,0,0
0,9,0,0,0,0,0,0,3
0,6,0,0,0,5,2,0,0
0,0,0,3,1,4,0,8,0
0,0,0,0,0,0,9,4,0
