2,4,9,8,5,6,7,3,1
1,6,8,3,4,7,9,2,5
7,3,5,2,1,9,8,6,4
4,9,1,5,3,8,6,7,2
5,2,3,6,7,1,4,9,8
6,8,7,9,2,4,5,1,3
9,1,6,4,8,3,2,5,7
3,5,4,7,9,2,1,8,6
8,7,2,1,6,5,3,4,9
