1,5,2,8,9,3,4,7,6
7,4,8,6,1,2,3,5,9
3,6,9,5,4,7,2,8,1
8,3,5,7,2,1,9,6,4
2,7,6,9,5,4,1,3,8
4,9,1,3,6,8,5,2,7
9,2,7,4,8,5,6,1,3
6,1,3,2,7,9,8,4,5
5,8,4,1,3,6,7,9,2
