5,4,3,8,6,1,9,2,7
9,6,2,5,3,7,8,4,1
1,8,7,2,9,4,6,5,3
8,5,1,9,7,2,3,6,4
7,2,6,3,4,8,1,9,5
4,3,9,6,1,5,7,8,2
3,1,8,4,5,9,2,7,6
6,9,4,7,2,3,5,1,8
2,7,5,1,8,6,4,3,9
